tax	Garnets-4	Kaites-Jenny	Kim-1	OMIB2	Pahala-4	Panaewa-1	VHS-4	Waminalo-3	total
Unclassified;Unknown;Unknown;Unknown;Unknown;Unknown;Unknown;Unknown	204082	297269	203222	174680	642421	286481	279373	422513	2510041
Eukaryota;Metazoa;Arthropoda;Insecta;Hymenoptera;Apidae;Apis;Apis mellifera	190859	227565	159725	211569	310671	130542	228196	383273	1842400
Viruses;Orthornavirae;Pisuviricota;Pisoniviricetes;Picornavirales;Iflaviridae;Iflavirus;Varroa destructor virus 1	85383	13	46532	215	19	21223	9	40630	194024
Viruses;Orthornavirae;Pisuviricota;Pisoniviricetes;Picornavirales;Iflaviridae;Iflavirus;Iflavirus aladeformis	10681	5	94908	85	24	18056	14	63197	186970
Bacteria;Bacteria_none;Bacillota;Bacilli;Lactobacillales;Enterococcaceae;Melissococcus;Melissococcus plutonius	13130	6401	16936	9814	8717	17153	3805	13334	89290
Bacteria;Bacteria_none;Pseudomonadota;Gammaproteobacteria;Orbales;Orbaceae;Gilliamella;Gilliamella apicola	5812	5419	10629	6047	3625	4689	1893	8456	46570
Bacteria;Bacteria_none;Pseudomonadota;Gammaproteobacteria;Orbales;Orbaceae;Frischella;Frischella perrara	1974	882	4863	2159	1035	2381	980	3958	18232
Bacteria;Bacteria_none;Bacillota;Bacilli;Lactobacillales;Lactobacillaceae;Bombilactobacillus;Bombilactobacillus mellis	2266	1097	4132	1787	1462	4152	353	2128	17377
Bacteria;Bacteria_none;Bacillota;Bacilli;Bacillales;Paenibacillaceae;Paenibacillus;Paenibacillus larvae	1753	1494	3196	2130	1095	2508	602	2844	15622
Bacteria;Bacteria_none;Pseudomonadota;Betaproteobacteria;Neisseriales;Neisseriaceae;Snodgrassella;Snodgrassella alvi	2200	1908	1774	1663	1161	1365	622	1663	12356
Bacteria;Bacteria_none;Bacillota;Bacilli;Lactobacillales;Lactobacillaceae;Lactobacillus;Lactobacillus apis	550	746	1692	2024	500	1147	270	2095	9024
Bacteria;Bacteria_none;Bacillota;Bacilli;Lactobacillales;Lactobacillaceae;Lactobacillus;Lactobacillus melliventris	963	344	739	740	617	1155	236	612	5406
Viruses;Orthornavirae;Kitrinoviricota;Magsaviricetes;Nodamuvirales;Sinhaliviridae;Sinaivirus;Lake Sinai Virus SA2	0	0	3534	0	1	0	0	900	4435
Viruses;Orthornavirae;Lenarviricota;Leviviricetes;Timlovirales;Steitzviridae;Kinglevirus;Kinglevirus lutadaptatum	521	297	591	1057	205	385	162	1154	4372
Bacteria;Bacteria_none;Bacteroidota;Flavobacteriia;Flavobacteriales;Weeksellaceae;Apibacter;Apibacter mensalis	352	54	554	342	473	546	10	301	2632
Bacteria;Bacteria_none;Bacillota;Bacilli;Lactobacillales;Lactobacillaceae;Lactobacillus;Lactobacillus helsingborgensis	452	87	288	358	298	486	271	380	2620
Bacteria;Bacteria_none;Pseudomonadota;Gammaproteobacteria;Orbales;Orbaceae;Gilliamella;Gilliamella mensalis	253	315	544	266	167	238	76	305	2164
Bacteria;Bacteria_none;Pseudomonadota;Gammaproteobacteria;Orbales;Orbaceae;Gilliamella;Gilliamella bombi	236	229	467	272	119	203	65	379	1970
Eukaryota;Metazoa;Arthropoda;Arachnida;Mesostigmata;Varroidae;Varroa;Varroa destructor	143	22	130	5	331	939	190	57	1817
Bacteria;Bacteria_none;Pseudomonadota;Gammaproteobacteria;Orbales;Orbaceae;Gilliamella;Gilliamella bombicola	208	207	477	257	98	197	63	284	1791
Bacteria;Bacteria_none;Bacillota;Bacilli;Lactobacillales;Lactobacillaceae;Lactobacillus;Lactobacillus kimbladii	254	103	157	243	99	166	43	131	1196
Bacteria;Bacteria_none;Bacillota;Bacilli;Lactobacillales;Lactobacillaceae;Lactobacillus;Lactobacillus huangpiensis	177	110	149	131	77	212	86	157	1099
Bacteria;Bacteria_none;Bacillota;Bacilli;Lactobacillales;Lactobacillaceae;Lactobacillus;Lactobacillus kullabergensis	136	67	141	143	76	240	56	162	1021
Bacteria;Bacteria_none;Bacillota;Bacilli;Lactobacillales;Lactobacillaceae;Bombilactobacillus;Bombilactobacillus mellifer	106	37	268	151	81	105	47	214	1009
Bacteria;Bacteria_none;Pseudomonadota;Alphaproteobacteria;Rhodospirillales;Acetobacteraceae;Commensalibacter;Commensalibacter intestini	191	22	90	86	120	211	104	77	901
Bacteria;Bacteria_none;Actinomycetota;Actinomycetes;Bifidobacteriales;Bifidobacteriaceae;Bifidobacterium;Bifidobacterium polysaccharolyticum	68	126	192	181	36	137	4	110	854
Bacteria;Bacteria_none;Pseudomonadota;Gammaproteobacteria;Orbales;Orbaceae;Gilliamella;Gilliamella intestini	67	68	191	87	47	65	26	126	677
Bacteria;Bacteria_none;Pseudomonadota;Betaproteobacteria;Neisseriales;Neisseriaceae;Snodgrassella;Snodgrassella gandavensis	105	88	138	96	47	100	28	75	677
Bacteria;Bacteria_none;Pseudomonadota;Gammaproteobacteria;Pseudomonadales;Pseudomonadaceae;Entomomonas;Entomomonas asaccharolytica	0	107	81	10	106	111	0	158	573
Bacteria;Bacteria_none;Pseudomonadota;Betaproteobacteria;Neisseriales;Neisseriaceae;Snodgrassella;Snodgrassella communis	79	67	101	84	40	84	17	63	535
Viruses;Orthornavirae;Kitrinoviricota;Magsaviricetes;Nodamuvirales;Sinhaliviridae;Sinaivirus;Lake Sinai virus 1	1	0	101	0	417	0	0	0	519
Bacteria;Bacteria_none;Pseudomonadota;Gammaproteobacteria;Orbales;Orbaceae;Frischella;Frischella japonica	71	31	127	63	32	57	30	95	506
Bacteria;Bacteria_none;Bacillota;Bacilli;Lactobacillales;Lactobacillaceae;Lactobacillus;Lactobacillus laiwuensis	75	35	72	56	29	110	47	72	496
Bacteria;Bacteria_none;Bacteroidota;Flavobacteriia;Flavobacteriales;Weeksellaceae;Apibacter;Apibacter adventoris	85	3	95	28	86	68	2	76	443
Viruses;Viruses_Incertae_sedis;Viruses_Incertae_sedis;Viruses_Incertae_sedis;Viruses_Incertae_sedis;Polydnaviriformidae;Ichnoviriform;Ichnoviriform fumiferanae	51	16	6	12	81	140	93	44	443
Bacteria;Bacteria_none;Actinomycetota;Actinomycetes;Bifidobacteriales;Bifidobacteriaceae;Bifidobacterium;Bifidobacterium mizhiense	21	57	98	84	14	58	4	91	427
Bacteria;Bacteria_none;Actinomycetota;Actinomycetes;Bifidobacteriales;Bifidobacteriaceae;Bifidobacterium;Bifidobacterium choladohabitans	19	25	83	106	13	40	3	72	361
Eukaryota;Fungi;Ascomycota;Dothideomycetes;Pleosporales;Halotthiaceae;Brunneoclavispora;Brunneoclavispora bambusae	31	42	26	35	37	43	12	113	339
Bacteria;Bacteria_none;Pseudomonadota;Alphaproteobacteria;Hyphomicrobiales;Bartonellaceae;Bartonella;Bartonella apis	17	45	45	59	4	15	13	112	310
Bacteria;Bacteria_none;Actinomycetota;Actinomycetes;Bifidobacteriales;Bifidobacteriaceae;Bifidobacterium;Bifidobacterium asteroides	14	42	57	52	11	44	1	53	274
Bacteria;Bacteria_none;Bacillota;Bacilli;Lactobacillales;Lactobacillaceae;Lactobacillus;Lactobacillus panisapium	34	7	40	49	37	42	16	38	263
Bacteria;Bacteria_none;Actinomycetota;Actinomycetes;Bifidobacteriales;Bifidobacteriaceae;Bifidobacterium;Bifidobacterium apousia	13	29	61	56	11	28	2	51	251
Bacteria;Bacteria_none;Bacteroidota;Bacteroidia;Bacteroidales;Dysgonomonadaceae;Dysgonomonas;Dysgonomonas capnocytophagoides	0	1	120	7	28	20	0	60	236
Bacteria;Bacteria_none;Pseudomonadota;Gammaproteobacteria;Pseudomonadales;Pseudomonadaceae;Entomomonas;Entomomonas moraniae	0	36	19	4	22	26	0	80	187
Bacteria;Bacteria_none;Bacillota;Bacilli;Lactobacillales;Lactobacillaceae;Bombilactobacillus;Bombilactobacillus thymidiniphilus	23	14	50	20	14	40	4	19	184
Bacteria;Bacteria_none;Bacillota;Bacilli;Lactobacillales;Lactobacillaceae;Lactobacillus;Lactobacillus bombicola	17	16	24	33	17	40	6	26	179
Bacteria;Bacteria_none;Actinomycetota;Actinomycetes;Bifidobacteriales;Bifidobacteriaceae;Bifidobacterium;Bifidobacterium coryneforme	12	30	35	22	5	19	2	48	173
Viruses;Heunggongvirae;Uroviricota;Caudoviricetes;Caudoviricetes_Incertae_sedis;Peduoviridae;Wadgaonvirus;Wadgaonvirus wv5004651	16	10	91	24	3	14	2	12	172
Bacteria;Bacteria_none;Pseudomonadota;Gammaproteobacteria;Orbales;Orbaceae;Orbus;Orbus sasakiae	24	12	20	37	9	9	6	34	151
Bacteria;Bacteria_none;Bacteroidota;Bacteroidia;Bacteroidales;Dysgonomonadaceae;Dysgonomonas;Dysgonomonas hofstadii	1	0	59	7	28	17	0	34	146
Viruses;Viruses_Incertae_sedis;Viruses_Incertae_sedis;Viruses_Incertae_sedis;Viruses_Incertae_sedis;Viruses_Incertae_sedis;Viruses_Incertae_sedis;Apis mellifera filamentous virus	30	1	4	1	33	8	28	21	126
Bacteria;Bacteria_none;Bacillota;Bacilli;Lactobacillales;Lactobacillaceae;Bombilactobacillus;Bombilactobacillus bombi	13	4	20	9	6	32	0	19	103
Bacteria;Bacteria_none;Actinomycetota;Actinomycetes;Bifidobacteriales;Bifidobacteriaceae;Bifidobacterium;Bifidobacterium indicum	6	20	15	12	6	12	1	23	95
Bacteria;Bacteria_none;Pseudomonadota;Gammaproteobacteria;Orbales;Orbaceae;Orbus;Orbus hercynius	20	3	22	5	7	7	2	27	93
Viruses;Orthornavirae;Kitrinoviricota;Magsaviricetes;Nodamuvirales;Sinhaliviridae;Sinaivirus;Lake Sinai virus	0	0	52	0	36	0	0	2	90
Bacteria;Bacteria_none;Bacteroidota;Bacteroidia;Bacteroidales;Dysgonomonadaceae;Dysgonomonas;Dysgonomonas massiliensis	1	0	35	5	5	23	0	16	85
Bacteria;Bacteria_none;Pseudomonadota;Gammaproteobacteria;Enterobacterales;Enterobacteriaceae;Klebsiella;Klebsiella oxytoca	2	2	0	58	0	5	0	12	79
Bacteria;Bacteria_none;Bacteroidota;Bacteroidia;Bacteroidales;Dysgonomonadaceae;Dysgonomonas;Dysgonomonas termitidis	0	0	27	4	13	19	0	15	78
Viruses;Orthornavirae;Pisuviricota;Pisoniviricetes;Picornavirales;Dicistroviridae;Triatovirus;Triatovirus nigereginacellulae	6	0	1	0	53	3	0	0	63
Eukaryota;Metazoa;Chordata;Mammalia;Artiodactyla;Suidae;Sus;Sus scrofa	6	7	5	5	9	10	10	6	58
Bacteria;Bacteria_none;Pseudomonadota;Gammaproteobacteria;Enterobacterales;Enterobacteriaceae;Klebsiella;Klebsiella pneumoniae	3	5	3	29	0	6	0	11	57
Bacteria;Bacteria_none;Pseudomonadota;Alphaproteobacteria;Hyphomicrobiales;Bartonellaceae;Bartonella;Bartonella vinsonii	0	10	11	21	1	0	0	13	56
Bacteria;Bacteria_none;Pseudomonadota;Alphaproteobacteria;Rhodospirillales;Acetobacteraceae;Endobacter;Endobacter medicaginis	16	3	7	0	7	8	9	5	55
Bacteria;Bacteria_none;Bacteroidota;Flavobacteriia;Flavobacteriales;Weeksellaceae;Apibacter;Apibacter raozihei	10	0	12	1	7	11	0	11	52
Bacteria;Bacteria_none;Pseudomonadota;Gammaproteobacteria;Enterobacterales;Enterobacteriaceae;Enterobacter;Enterobacter quasihormaechei	8	5	5	3	0	0	1	27	49
Bacteria;Bacteria_none;Pseudomonadota;Gammaproteobacteria;Enterobacterales;Enterobacteriaceae;Enterobacter;Enterobacter cloacae	11	2	6	7	0	2	1	19	48
Bacteria;Bacteria_none;Bacteroidota;Bacteroidia;Bacteroidales;Dysgonomonadaceae;Dysgonomonas;Dysgonomonas mossii	0	0	18	4	6	9	0	11	48
Bacteria;Bacteria_none;Pseudomonadota;Gammaproteobacteria;Enterobacterales;Enterobacteriaceae;Klebsiella;Klebsiella variicola	0	3	0	36	0	0	2	6	47
Bacteria;Bacteria_none;Pseudomonadota;Gammaproteobacteria;Enterobacterales;Enterobacteriaceae;Enterobacter;Enterobacter sichuanensis	3	1	2	10	1	23	0	3	43
Bacteria;Bacteria_none;Pseudomonadota;Alphaproteobacteria;Rhodospirillales;Acetobacteraceae;Bombella;Bombella apis	3	0	0	4	5	21	0	9	42
Bacteria;Bacteria_none;Bacillota;Bacilli;Lactobacillales;Lactobacillaceae;Apilactobacillus;Apilactobacillus kunkeei	1	0	10	5	0	7	0	18	41
Bacteria;Bacteria_none;Bacillota;Bacilli;Lactobacillales;Lactobacillaceae;Lactobacillus;Lactobacillus gallinarum	3	1	12	4	0	3	3	15	41
Bacteria;Bacteria_none;Pseudomonadota;Alphaproteobacteria;Rhodospirillales;Acetobacteraceae;Bombella;Bombella intestini	4	0	2	6	0	9	0	19	40
Bacteria;Bacteria_none;Pseudomonadota;Betaproteobacteria;Neisseriales;Neisseriaceae;Uruburuella;Uruburuella suis	5	3	4	5	9	4	1	8	39
Bacteria;Bacteria_none;Pseudomonadota;Gammaproteobacteria;Enterobacterales;Enterobacteriaceae;Kosakonia;Kosakonia cowanii	3	1	1	19	0	6	0	9	39
Bacteria;Bacteria_none;Pseudomonadota;Gammaproteobacteria;Enterobacterales;Enterobacteriaceae;Citrobacter;Citrobacter telavivensis	0	2	0	3	0	0	30	3	38
Bacteria;Bacteria_none;Bacillota;Bacilli;Lactobacillales;Lactobacillaceae;Lactobacillus;Lactobacillus helveticus	3	1	7	6	1	7	1	10	36
Viruses;Bamfordvirae;Nucleocytoviricota;Megaviricetes;Imitervirales;Mimiviridae;Theiavirus;Theiavirus salishense	2	6	1	1	12	7	3	4	36
Bacteria;Bacteria_none;Pseudomonadota;Gammaproteobacteria;Enterobacterales;Enterobacteriaceae;Enterobacter;Enterobacter quasiroggenkampii	3	1	1	2	1	20	0	5	33
Eukaryota;Metazoa;Chordata;Mammalia;Primates;Cercopithecidae;Chlorocebus;Chlorocebus sabaeus	6	3	1	5	7	3	3	5	33
Viruses;Orthornavirae;Kitrinoviricota;Magsaviricetes;Nodamuvirales;Sinhaliviridae;Sinaivirus;Lake Sinai Virus NE	0	0	12	0	20	0	0	0	32
Bacteria;Bacteria_none;Bacillota;Bacilli;Lactobacillales;Lactobacillaceae;Lactobacillus;Lactobacillus colini	1	5	4	5	4	7	2	4	32
Eukaryota;Fungi;Ascomycota;Dothideomycetes;Pleosporales;Pleosporales_Incertae_sedis;Mangifericomes;Mangifericomes hongheensis	6	4	0	1	4	5	1	10	31
Bacteria;Bacteria_none;Bacteroidota;Bacteroidia;Bacteroidales;Dysgonomonadaceae;Dysgonomonas;Dysgonomonas oryzarvi	0	0	11	2	3	8	0	6	30
Bacteria;Bacteria_none;Bacteroidota;Bacteroidia;Bacteroidales;Dysgonomonadaceae;Dysgonomonas;Dysgonomonas gadei	0	0	5	1	4	10	0	9	29
Bacteria;Bacteria_none;Pseudomonadota;Gammaproteobacteria;Enterobacterales;Enterobacteriaceae;Enterobacter;Enterobacter asburiae	3	2	4	6	2	0	1	10	28
Bacteria;Bacteria_none;Pseudomonadota;Gammaproteobacteria;Enterobacterales;Enterobacteriaceae;Escherichia;Escherichia fergusonii	2	1	1	4	0	2	3	12	25
Bacteria;Bacteria_none;Pseudomonadota;Gammaproteobacteria;Enterobacterales;Enterobacteriaceae;Cedecea;Cedecea lapagei	0	0	0	24	0	0	0	1	25
Bacteria;Bacteria_none;Pseudomonadota;Gammaproteobacteria;Enterobacterales;Enterobacteriaceae;Enterobacter;Enterobacter hormaechei	3	2	1	0	0	0	1	17	24
Bacteria;Bacteria_none;Pseudomonadota;Alphaproteobacteria;Rhodospirillales;Acetobacteraceae;Gluconobacter;Gluconobacter japonicus	3	0	2	5	4	6	3	0	23
Bacteria;Bacteria_none;Bacillota;Bacilli;Lactobacillales;Lactobacillaceae;Apilactobacillus;Apilactobacillus apinorum	2	1	4	6	0	0	0	10	23
Viruses;Bamfordvirae;Nucleocytoviricota;Pokkesviricetes;Chitovirales;Poxviridae;Orthopoxvirus;Ectromelia virus	1	1	2	0	8	1	4	5	22
Bacteria;Bacteria_none;Pseudomonadota;Alphaproteobacteria;Rhodospirillales;Acetobacteraceae;Entomobacter;Entomobacter blattae	3	0	4	7	2	5	0	1	22
Bacteria;Bacteria_none;Pseudomonadota;Gammaproteobacteria;Enterobacterales;Enterobacteriaceae;Kluyvera;Kluyvera sichuanensis	0	0	5	5	0	0	0	12	22
Viruses;Bamfordvirae;Nucleocytoviricota;Megaviricetes;Imitervirales;Mimiviridae;Megavirus;Megavirus powaiense	0	3	0	2	9	3	0	5	22
Bacteria;Bacteria_none;Bacillota;Bacilli;Lactobacillales;Lactobacillaceae;Companilactobacillus;Companilactobacillus suantsaicola	3	2	5	1	2	7	0	2	22
Bacteria;Bacteria_none;Pseudomonadota;Alphaproteobacteria;Rhodospirillales;Acetobacteraceae;Gluconobacter;Gluconobacter frateurii	2	0	1	4	4	4	5	1	21
Eukaryota;Fungi;Ascomycota;Archaeorhizomycetes;Archaeorhizomycetales;Archaeorhizomycetaceae;Archaeorhizomyces;Archaeorhizomyces finlayi	0	0	0	0	0	21	0	0	21
Bacteria;Bacteria_none;Pseudomonadota;Gammaproteobacteria;Enterobacterales;Enterobacteriaceae;Enterobacter;Enterobacter mori	0	0	3	3	1	12	0	2	21
Bacteria;Bacteria_none;Actinomycetota;Actinomycetes;Bifidobacteriales;Bifidobacteriaceae;Bifidobacterium;Bifidobacterium thermophilum	0	3	5	6	0	2	0	5	21
Bacteria;Bacteria_none;Bacillota;Bacilli;Lactobacillales;Lactobacillaceae;Apilactobacillus;Apilactobacillus nanyangensis	0	0	2	1	0	2	0	15	20
Viruses;Heunggongvirae;Uroviricota;Caudoviricetes;Caudoviricetes_Incertae_sedis;Caudoviricetes_Incertae_sedis;Branisovskavirus;Branisovskavirus Kc263	0	4	0	0	8	3	1	4	20
Bacteria;Bacteria_none;Bacteroidota;Bacteroidia;Bacteroidales;Dysgonomonadaceae;Seramator;Seramator thermalis	0	0	9	1	1	5	0	4	20
Bacteria;Bacteria_none;Pseudomonadota;Alphaproteobacteria;Rhodospirillales;Acetobacteraceae;Bombella;Bombella favorum	0	0	1	3	1	6	0	8	19
Bacteria;Bacteria_none;Pseudomonadota;Gammaproteobacteria;Enterobacterales;Enterobacteriaceae;Atlantibacter;Atlantibacter hermannii	5	0	1	10	0	2	0	0	18
Bacteria;Bacteria_none;Pseudomonadota;Gammaproteobacteria;Enterobacterales;Enterobacteriaceae;Pseudescherichia;Pseudescherichia vulneris	0	0	3	13	0	0	2	0	18
Bacteria;Bacteria_none;Pseudomonadota;Gammaproteobacteria;Enterobacterales;Enterobacteriaceae;Citrobacter;Citrobacter amalonaticus	1	0	1	2	0	0	12	1	17
Bacteria;Bacteria_none;Pseudomonadota;Gammaproteobacteria;Enterobacterales;Enterobacteriaceae;Yokenella;Yokenella regensburgei	0	2	7	7	0	0	1	0	17
Bacteria;Bacteria_none;Pseudomonadota;Gammaproteobacteria;Enterobacterales;Morganellaceae;Morganella;Morganella morganii	1	5	2	1	3	0	0	5	17
Bacteria;Bacteria_none;Pseudomonadota;Gammaproteobacteria;Enterobacterales;Yersiniaceae;Serratia;Serratia surfactantfaciens	0	2	0	7	0	0	0	8	17
Bacteria;Bacteria_none;Pseudomonadota;Alphaproteobacteria;Rhodospirillales;Acetobacteraceae;Novacetimonas;Novacetimonas hansenii	3	1	1	1	1	2	4	3	16
Bacteria;Bacteria_none;Pseudomonadota;Gammaproteobacteria;Enterobacterales;Yersiniaceae;Serratia;Serratia marcescens	0	2	0	12	0	1	0	1	16
Bacteria;Bacteria_none;Bacteroidota;Flavobacteriia;Flavobacteriales;Weeksellaceae;Apibacter;Apibacter muscae	4	1	1	0	2	4	0	4	16
Bacteria;Bacteria_none;Pseudomonadota;Alphaproteobacteria;Rhodospirillales;Acetobacteraceae;Bombella;Bombella mellum	4	0	1	1	4	4	0	2	16
Bacteria;Bacteria_none;Bacillota;Bacilli;Lactobacillales;Lactobacillaceae;Apilactobacillus;Apilactobacillus zhangqiuensis	1	0	3	2	0	1	0	8	15
Bacteria;Bacteria_none;Pseudomonadota;Gammaproteobacteria;Enterobacterales;Erwiniaceae;Izhakiella;Izhakiella australiensis	6	0	0	0	7	0	2	0	15
Bacteria;Bacteria_none;Actinomycetota;Actinomycetes;Bifidobacteriales;Bifidobacteriaceae;Bifidobacterium;Bifidobacterium rousetti	0	5	2	4	0	1	0	3	15
Bacteria;Bacteria_none;Bacteroidota;Bacteroidia;Bacteroidales;Odoribacteraceae;Odoribacter;Odoribacter splanchnicus	0	0	11	2	1	0	0	1	15
Bacteria;Bacteria_none;Pseudomonadota;Gammaproteobacteria;Enterobacterales;Enterobacteriaceae;Klebsiella;Klebsiella pasteurii	4	1	0	4	0	0	0	6	15
Bacteria;Bacteria_none;Pseudomonadota;Gammaproteobacteria;Enterobacterales;Enterobacteriaceae;Klebsiella;Klebsiella quasipneumoniae	1	1	3	3	0	1	1	5	15
Bacteria;Bacteria_none;Actinomycetota;Actinomycetes;Bifidobacteriales;Bifidobacteriaceae;Bifidobacterium;Bifidobacterium apri	0	2	5	1	1	4	0	2	15
Bacteria;Bacteria_none;Pseudomonadota;Gammaproteobacteria;Enterobacterales;Enterobacteriaceae;Salmonella;Salmonella bongori	1	1	0	7	0	4	0	1	14
Bacteria;Bacteria_none;Actinomycetota;Actinomycetes;Bifidobacteriales;Bifidobacteriaceae;Bifidobacterium;Bifidobacterium xylocopae	0	1	3	3	0	4	0	3	14
Bacteria;Bacteria_none;Pseudomonadota;Gammaproteobacteria;Enterobacterales;Enterobacteriaceae;Citrobacter;Citrobacter braakii	0	9	3	1	0	0	0	1	14
Bacteria;Bacteria_none;Pseudomonadota;Gammaproteobacteria;Enterobacterales;Enterobacteriaceae;Pluralibacter;Pluralibacter gergoviae	1	2	1	6	1	0	0	2	13
Bacteria;Bacteria_none;Pseudomonadota;Gammaproteobacteria;Enterobacterales;Erwiniaceae;Pantoea;Pantoea agglomerans	2	1	1	5	0	0	1	3	13
Viruses;Bamfordvirae;Nucleocytoviricota;Megaviricetes;Algavirales;Phycodnaviridae;Phycodnaviridae_Incertae_sedis;Orpheovirus IHUMI-LCC2	0	1	3	1	3	2	2	1	13
Viruses;Heunggongvirae;Peploviricota;Herviviricetes;Herpesvirales;Alloherpesviridae;Cyvirus;Cyvirus cyprinidallo2	0	1	1	0	6	1	0	3	12
Viruses;Heunggongvirae;Uroviricota;Caudoviricetes;Caudoviricetes_Incertae_sedis;Caudoviricetes_Incertae_sedis;Muvirus;Muvirus SfMu	9	0	0	0	1	0	0	2	12
Bacteria;Bacteria_none;Actinomycetota;Actinomycetes;Bifidobacteriales;Bifidobacteriaceae;Bifidobacterium;Bifidobacterium saimiriisciurei	1	1	4	2	0	1	0	3	12
Bacteria;Bacteria_none;Actinomycetota;Actinomycetes;Bifidobacteriales;Bifidobacteriaceae;Bifidobacterium;Bifidobacterium callitrichos	0	3	2	3	0	2	0	2	12
Viruses;Heunggongvirae;Uroviricota;Caudoviricetes;Caudoviricetes_Incertae_sedis;Caudoviricetes_Incertae_sedis;Muvirus;Muvirus mu	7	0	1	0	1	0	0	2	11
Bacteria;Bacteria_none;Actinomycetota;Actinomycetes;Bifidobacteriales;Bifidobacteriaceae;Bifidobacterium;Bifidobacterium bifidum	1	0	4	2	0	2	0	2	11
Bacteria;Bacteria_none;Bacteroidota;Bacteroidia;Bacteroidales;Tannerellaceae;Parabacteroides;Parabacteroides pacaensis	0	0	8	0	2	0	0	1	11
Bacteria;Bacteria_none;Pseudomonadota;Alphaproteobacteria;Hyphomicrobiales;Rhizobiaceae;Rhizobium;Rhizobium helanshanense	0	2	1	2	0	0	0	6	11
Bacteria;Bacteria_none;Pseudomonadota;Gammaproteobacteria;Enterobacterales;Enterobacteriaceae;Huaxiibacter;Huaxiibacter chinensis	1	1	2	6	0	0	0	1	11
Bacteria;Bacteria_none;Pseudomonadota;Gammaproteobacteria;Enterobacterales;Enterobacteriaceae;Kluyvera;Kluyvera cryocrescens	0	2	1	5	0	0	0	3	11
Bacteria;Bacteria_none;Bacteroidota;Bacteroidia;Bacteroidales;Bacteroidaceae;Phocaeicola;Phocaeicola paurosaccharolyticus	0	0	2	0	4	3	0	1	10
Bacteria;Bacteria_none;Pseudomonadota;Gammaproteobacteria;Enterobacterales;Enterobacteriaceae;Enterobacter;Enterobacter wuhouensis	3	1	0	2	1	1	0	2	10
Bacteria;Bacteria_none;Pseudomonadota;Gammaproteobacteria;Enterobacterales;Enterobacteriaceae;Enterobacter;Enterobacter oligotrophicus	3	0	3	2	0	2	0	0	10
Bacteria;Bacteria_none;Pseudomonadota;Alphaproteobacteria;Rhodospirillales;Acetobacteraceae;Saccharibacter;Saccharibacter floricola	0	1	0	0	0	5	2	2	10
Bacteria;Bacteria_none;Pseudomonadota;Alphaproteobacteria;Rhodospirillales;Acetobacteraceae;Parasaccharibacter;Parasaccharibacter apium	3	0	0	1	1	0	0	5	10
Bacteria;Bacteria_none;Pseudomonadota;Gammaproteobacteria;Aeromonadales;Aeromonadaceae;Aeromonas;Aeromonas hydrophila	0	10	0	0	0	0	0	0	10
Viruses;Heunggongvirae;Uroviricota;Caudoviricetes;Caudoviricetes_Incertae_sedis;Caudoviricetes_Incertae_sedis;Punavirus;Punavirus P1	2	0	0	1	1	1	3	2	10
Bacteria;Bacteria_none;Pseudomonadota;Alphaproteobacteria;Rhodospirillales;Acetobacteraceae;Gluconacetobacter;Gluconacetobacter diazotrophicus	0	0	0	0	4	5	0	0	9
Bacteria;Bacteria_none;Bacillota;Bacilli;Lactobacillales;Lactobacillaceae;Lactobacillus;Lactobacillus iners	0	0	2	3	0	3	0	1	9
Viruses;Bamfordvirae;Preplasmiviricota;Tectiliviricetes;Rowavirales;Adenoviridae;Aviadenovirus;Duck aviadenovirus B	0	2	0	0	4	0	2	1	9
Bacteria;Bacteria_none;Pseudomonadota;Gammaproteobacteria;Enterobacterales;Enterobacteriaceae;Phytobacter;Phytobacter diazotrophicus	5	1	0	2	0	0	1	0	9
Bacteria;Bacteria_none;Pseudomonadota;Gammaproteobacteria;Enterobacterales;Enterobacteriaceae;Leclercia;Leclercia pneumoniae	0	1	4	4	0	0	0	0	9
Viruses;Bamfordvirae;Nucleocytoviricota;Pokkesviricetes;Chitovirales;Poxviridae;Orthopoxvirus;Orthopoxvirus abatinomacacapox	1	0	3	0	3	0	0	2	9
Viruses;Heunggongvirae;Uroviricota;Caudoviricetes;Caudoviricetes_Incertae_sedis;Peduoviridae;Gegavirus;Gegavirus ST15OXA48phi141	0	1	3	2	1	0	0	2	9
Bacteria;Bacteria_none;Pseudomonadota;Gammaproteobacteria;Enterobacterales;Enterobacteriaceae;Raoultella;Raoultella planticola	1	2	2	4	0	0	0	0	9
Bacteria;Bacteria_none;Bacillota;Bacilli;Lactobacillales;Lactobacillaceae;Lactobacillus;Lactobacillus ultunensis	1	0	1	0	1	2	0	4	9
Viruses;Bamfordvirae;Nucleocytoviricota;Megaviricetes;Algavirales;Phycodnaviridae;Prymnesiovirus;Chrysochromulina parva virus	1	1	0	0	5	0	2	0	9
Bacteria;Bacteria_none;Pseudomonadota;Gammaproteobacteria;Enterobacterales;Enterobacteriaceae;Kosakonia;Kosakonia sacchari	1	0	0	0	0	0	0	8	9
Bacteria;Bacteria_none;Bacillota;Bacilli;Lactobacillales;Lactobacillaceae;Companilactobacillus;Companilactobacillus nuruki	1	1	1	0	1	4	0	1	9
Bacteria;Bacteria_none;Pseudomonadota;Gammaproteobacteria;Enterobacterales;Enterobacteriaceae;Cronobacter;Cronobacter muytjensii	2	1	0	5	0	0	1	0	9
Bacteria;Bacteria_none;Pseudomonadota;Gammaproteobacteria;Enterobacterales;Enterobacteriaceae;Citrobacter;Citrobacter bitternis	1	2	0	2	0	1	3	0	9
Viruses;Heunggongvirae;Uroviricota;Caudoviricetes;Caudoviricetes_Incertae_sedis;Caudoviricetes_Incertae_sedis;Caudoviricetes_Incertae_sedis;Lactobacillus phage KC5a	1	2	0	0	2	1	0	2	8
Bacteria;Bacteria_none;Pseudomonadota;Gammaproteobacteria;Enterobacterales;Enterobacteriaceae;Citrobacter;Citrobacter murliniae	2	2	1	1	0	0	0	2	8
Bacteria;Bacteria_none;Pseudomonadota;Gammaproteobacteria;Moraxellales;Moraxellaceae;Psychrobacter;Psychrobacter aestuarii	2	1	0	1	2	1	0	1	8
Bacteria;Bacteria_none;Pseudomonadota;Gammaproteobacteria;Enterobacterales;Enterobacteriaceae;Kluyvera;Kluyvera ascorbata	0	0	3	2	0	0	0	3	8
Bacteria;Bacteria_none;Bacillota;Bacilli;Lactobacillales;Lactobacillaceae;Lactobacillus;Lactobacillus acidophilus	0	0	0	2	2	1	0	3	8
Bacteria;Bacteria_none;Pseudomonadota;Gammaproteobacteria;Enterobacterales;Enterobacteriaceae;Kluyvera;Kluyvera intermedia	0	0	3	4	0	0	0	1	8
Bacteria;Bacteria_none;Pseudomonadota;Gammaproteobacteria;Enterobacterales;Yersiniaceae;Serratia;Serratia nematodiphila	0	2	0	6	0	0	0	0	8
Bacteria;Bacteria_none;Pseudomonadota;Alphaproteobacteria;Rhodospirillales;Acetobacteraceae;Gluconobacter;Gluconobacter thailandicus	1	0	2	0	0	3	1	1	8
Bacteria;Bacteria_none;Pseudomonadota;Alphaproteobacteria;Rhodospirillales;Acetobacteraceae;Lichenicoccus;Lichenicoccus roseus	2	0	1	2	2	0	0	1	8
Bacteria;Bacteria_none;Pseudomonadota;Gammaproteobacteria;Orbales;Orbaceae;Zophobihabitans;Zophobihabitans entericus	1	1	5	0	0	1	0	0	8
Bacteria;Bacteria_none;Pseudomonadota;Gammaproteobacteria;Pasteurellales;Pasteurellaceae;Pasteurellaceae_Incertae_sedis;[Pasteurella] mairii	5	0	0	0	2	0	0	1	8
Bacteria;Bacteria_none;Pseudomonadota;Gammaproteobacteria;Enterobacterales;Enterobacteriaceae;Enterobacter;Enterobacter soli	0	0	1	0	0	6	0	0	7
Bacteria;Bacteria_none;Pseudomonadota;Alphaproteobacteria;Hyphomicrobiales;Rhizobiaceae;Endobacterium;Endobacterium yantingense	0	1	1	5	0	0	0	0	7
Bacteria;Bacteria_none;Pseudomonadota;Gammaproteobacteria;Enterobacterales;Enterobacteriaceae;Klebsiella;Klebsiella aerogenes	1	4	0	1	0	0	0	1	7
Bacteria;Bacteria_none;Pseudomonadota;Gammaproteobacteria;Enterobacterales;Enterobacteriaceae;Enterobacter;Enterobacter chuandaensis	0	0	0	4	2	0	0	1	7
Eukaryota;Fungi;Chytridiomycota;Chytridiomycetes;Spizellomycetales;Spizellomycetaceae;Spizellomyces;Spizellomyces punctatus	2	1	0	2	0	0	0	2	7
Bacteria;Bacteria_none;Pseudomonadota;Alphaproteobacteria;Rhodospirillales;Acetobacteraceae;Acetobacter;Acetobacter thailandicus	1	0	0	0	1	4	1	0	7
Eukaryota;Fungi;Zoopagomycota;Kickxellomycetes;Kickxellales;Kickxellaceae;Spiromyces;Spiromyces aspiralis	1	0	1	2	2	1	0	0	7
Bacteria;Bacteria_none;Pseudomonadota;Gammaproteobacteria;Enterobacterales;Enterobacteriaceae;Shimwellia;Shimwellia blattae	0	0	0	3	0	3	0	1	7
Bacteria;Bacteria_none;Actinomycetota;Actinomycetes;Bifidobacteriales;Bifidobacteriaceae;Bifidobacterium;Bifidobacterium actinocoloniiforme	0	1	2	0	0	3	0	1	7
Bacteria;Bacteria_none;Bacillota;Bacilli;Lactobacillales;Lactobacillaceae;Companilactobacillus;Companilactobacillus nantensis	1	1	1	0	2	1	0	1	7
Bacteria;Bacteria_none;Pseudomonadota;Gammaproteobacteria;Enterobacterales;Morganellaceae;Providencia;Providencia alcalifaciens	0	5	0	1	0	0	0	0	6
Bacteria;Bacteria_none;Bacteroidota;Bacteroidia;Bacteroidales;Dysgonomonadaceae;Petrimonas;Petrimonas mucosa	0	0	3	0	3	0	0	0	6
Bacteria;Bacteria_none;Pseudomonadota;Alphaproteobacteria;Rhodospirillales;Acetobacteraceae;Swaminathania;Swaminathania salitolerans	0	0	1	5	0	0	0	0	6
Eukaryota;Fungi;Ascomycota;Sordariomycetes;Hypocreales;Hypocreales_Incertae_sedis;Chlamydocillium;Chlamydocillium curvulum	0	0	1	0	0	2	1	2	6
Bacteria;Bacteria_none;Bacillota;Bacilli;Lactobacillales;Lactobacillaceae;Lactobacillus;Lactobacillus porci	1	0	1	1	0	0	0	3	6
Bacteria;Bacteria_none;Pseudomonadota;Gammaproteobacteria;Enterobacterales;Enterobacteriaceae;Shigella;Shigella flexneri	0	1	0	3	0	1	0	1	6
Bacteria;Bacteria_none;Pseudomonadota;Gammaproteobacteria;Enterobacterales;Enterobacteriaceae;Phytobacter;Phytobacter massiliensis	1	1	0	0	0	1	1	2	6
Bacteria;Bacteria_none;Pseudomonadota;Gammaproteobacteria;Enterobacterales;Enterobacteriaceae;Citrobacter;Citrobacter tructae	3	3	0	0	0	0	0	0	6
Bacteria;Bacteria_none;Bacteroidota;Bacteroidia;Bacteroidales;Tannerellaceae;Parabacteroides;Parabacteroides gordonii	0	0	2	0	0	4	0	0	6
Eukaryota;Fungi;Chytridiomycota;Chytridiomycetes;Spizellomycetales;Powellomycetaceae;Fimicolochytrium;Fimicolochytrium jonesii	1	1	2	0	1	0	1	0	6
Viruses;Heunggongvirae;Peploviricota;Herviviricetes;Herpesvirales;Orthoherpesviridae;Varicellovirus;Varicellovirus cervidalpha3	1	0	0	1	2	0	2	0	6
Bacteria;Bacteria_none;Pseudomonadota;Gammaproteobacteria;Enterobacterales;Enterobacteriaceae;Leclercia;Leclercia tamurae	1	0	0	4	0	0	0	1	6
Bacteria;Bacteria_none;Bacillota;Bacilli;Lactobacillales;Lactobacillaceae;Fructobacillus;Fructobacillus fructosus	0	0	0	0	0	0	0	6	6
Viruses;Bamfordvirae;Nucleocytoviricota;Pokkesviricetes;Chitovirales;Poxviridae;Salmonpoxvirus;Salmon gillpox virus	1	1	0	0	1	0	3	0	6
Viruses;Bamfordvirae;Nucleocytoviricota;Pokkesviricetes;Chitovirales;Poxviridae;Orthopoxvirus;Monkeypox virus	0	1	3	0	0	0	1	1	6
Bacteria;Bacteria_none;Bacillota;Bacilli;Lactobacillales;Lactobacillaceae;Lactobacillus;Lactobacillus gasseri	1	2	0	1	0	0	0	2	6
Eukaryota;Fungi;Ascomycota;Taphrinomycetes;Taphrinales;Taphrinaceae;Taphrina;Taphrina communis	0	0	1	2	1	0	0	2	6
Bacteria;Bacteria_none;Pseudomonadota;Gammaproteobacteria;Pseudomonadales;Pseudomonadaceae;Pseudomonas;Pseudomonas yamanorum	1	1	0	3	0	0	0	1	6
Bacteria;Bacteria_none;Pseudomonadota;Gammaproteobacteria;Enterobacterales;Enterobacteriaceae;Kosakonia;Kosakonia pseudosacchari	1	0	0	4	0	0	0	0	5
Bacteria;Bacteria_none;Bacillota;Clostridia;Eubacteriales;Eubacteriales_Incertae_sedis;Anaerotalea;Anaerotalea alkaliphila	0	0	0	4	0	0	0	1	5
Bacteria;Bacteria_none;Pseudomonadota;Gammaproteobacteria;Moraxellales;Moraxellaceae;Acinetobacter;Acinetobacter nectaris	1	0	0	0	1	1	0	2	5
Bacteria;Bacteria_none;Pseudomonadota;Gammaproteobacteria;Enterobacterales;Enterobacteriaceae;Salmonella;Salmonella enterica	0	1	0	3	0	0	1	0	5
Bacteria;Bacteria_none;Pseudomonadota;Gammaproteobacteria;Enterobacterales;Enterobacteriaceae;Raoultella;Raoultella ornithinolytica	1	2	0	1	0	0	0	1	5
Bacteria;Bacteria_none;Pseudomonadota;Gammaproteobacteria;Enterobacterales;Enterobacteriaceae;Scandinavium;Scandinavium goeteborgense	1	0	1	3	0	0	0	0	5
Bacteria;Bacteria_none;Pseudomonadota;Gammaproteobacteria;Enterobacterales;Bruguierivoracaceae;Sodalis;Sodalis praecaptivus	1	0	0	0	3	0	0	1	5
Bacteria;Bacteria_none;Pseudomonadota;Alphaproteobacteria;Rhodospirillales;Acetobacteraceae;Kozakia;Kozakia baliensis	0	0	1	1	1	1	1	0	5
Bacteria;Bacteria_none;Pseudomonadota;Alphaproteobacteria;Rhodospirillales;Acetobacteraceae;Gluconobacter;Gluconobacter morbifer	0	0	0	4	0	0	0	1	5
Bacteria;Bacteria_none;Pseudomonadota;Alphaproteobacteria;Rhodospirillales;Acetobacteraceae;Brytella;Brytella acorum	1	0	1	1	1	1	0	0	5
Viruses;Heunggongvirae;Peploviricota;Herviviricetes;Herpesvirales;Orthoherpesviridae;Varicellovirus;Varicellovirus cervidalpha2	0	1	0	0	2	0	1	1	5
Bacteria;Bacteria_none;Bacteroidota;Bacteroidia;Bacteroidales;Tannerellaceae;Tannerella;Tannerella forsythia	0	0	3	0	1	0	0	1	5
Viruses;Heunggongvirae;Peploviricota;Herviviricetes;Herpesvirales;Orthoherpesviridae;Macavirus;Macavirus ovinegamma2	0	0	0	2	0	0	1	2	5
Bacteria;Bacteria_none;Pseudomonadota;Gammaproteobacteria;Enterobacterales;Enterobacteriaceae;Kosakonia;Kosakonia oryzendophytica	2	1	0	2	0	0	0	0	5
Bacteria;Bacteria_none;Pseudomonadota;Gammaproteobacteria;Enterobacterales;Enterobacteriaceae;Cronobacter;Cronobacter sakazakii	0	0	0	0	0	0	5	0	5
Bacteria;Bacteria_none;Pseudomonadota;Gammaproteobacteria;Enterobacterales;Enterobacteriaceae;Escherichia;Escherichia coli	0	0	1	0	0	1	0	3	5
Viruses;Heunggongvirae;Uroviricota;Caudoviricetes;Caudoviricetes_Incertae_sedis;Peduoviridae;Gegevirus;Gegevirus ST437OXA245phi41	1	0	1	2	0	0	0	1	5
Eukaryota;Fungi;Ascomycota;Saccharomycetes;Saccharomycetales;Saccharomycetaceae;Zygosaccharomyces;Zygosaccharomyces rouxii	0	3	0	1	0	0	0	1	5
Bacteria;Bacteria_none;Pseudomonadota;Betaproteobacteria;Neisseriales;Neisseriaceae;Paralysiella;Paralysiella testudinis	1	1	1	0	1	0	0	0	4
Bacteria;Bacteria_none;Bacteroidota;Flavobacteriia;Flavobacteriales;Weeksellaceae;Chryseobacterium;Chryseobacterium frigidum	0	0	1	0	0	2	0	1	4
Bacteria;Bacteria_none;Pseudomonadota;Gammaproteobacteria;Enterobacterales;Pectobacteriaceae;Pectobacterium;Pectobacterium polaris	0	1	2	1	0	0	0	0	4
Bacteria;Bacteria_none;Bacillota;Bacilli;Lactobacillales;Lactobacillaceae;Convivina;Convivina intestini	0	0	0	0	0	0	0	4	4
Bacteria;Bacteria_none;Pseudomonadota;Gammaproteobacteria;Enterobacterales;Morganellaceae;Providencia;Providencia rustigianii	0	3	0	0	0	0	0	1	4
Bacteria;Bacteria_none;Pseudomonadota;Betaproteobacteria;Neisseriales;Neisseriaceae;Neisseria;Neisseria perflava	0	1	0	0	0	1	1	1	4
Bacteria;Bacteria_none;Pseudomonadota;Gammaproteobacteria;Enterobacterales;Enterobacteriaceae;Shigella;Shigella dysenteriae	0	0	1	1	0	1	0	1	4
Bacteria;Bacteria_none;Pseudomonadota;Gammaproteobacteria;Moraxellales;Moraxellaceae;Acinetobacter;Acinetobacter baretiae	2	0	0	0	0	0	0	2	4
Bacteria;Bacteria_none;Pseudomonadota;Gammaproteobacteria;Enterobacterales;Morganellaceae;Providencia;Providencia vermicola	0	0	0	1	0	0	0	3	4
Viruses;Heunggongvirae;Uroviricota;Caudoviricetes;Caudoviricetes_Incertae_sedis;Casjensviridae;Dunedinvirus;Dunedinvirus JS26	0	0	0	0	4	0	0	0	4
Bacteria;Bacteria_none;Pseudomonadota;Gammaproteobacteria;Enterobacterales;Enterobacteriaceae;Pseudocitrobacter;Pseudocitrobacter vendiensis	0	3	0	0	0	0	0	1	4
Bacteria;Bacteria_none;Bacteroidota;Bacteroidia;Marinilabiliales;Marinilabiliaceae;Saccharicrinis;Saccharicrinis aurantiacus	0	0	3	0	1	0	0	0	4
Bacteria;Bacteria_none;Pseudomonadota;Gammaproteobacteria;Enterobacterales;Enterobacteriaceae;Enterobacter;Enterobacter cancerogenus	0	1	0	1	1	0	0	1	4
Bacteria;Bacteria_none;Pseudomonadota;Gammaproteobacteria;Enterobacterales;Pectobacteriaceae;Dickeya;Dickeya chrysanthemi	0	0	1	2	0	0	0	1	4
Bacteria;Bacteria_none;Pseudomonadota;Gammaproteobacteria;Enterobacterales;Enterobacteriaceae;Leclercia;Leclercia adecarboxylata	2	0	0	2	0	0	0	0	4
Bacteria;Bacteria_none;Pseudomonadota;Gammaproteobacteria;Enterobacterales;Enterobacteriaceae;Enterobacter;Enterobacter ludwigii	0	1	1	1	1	0	0	0	4
Bacteria;Bacteria_none;Bacteroidota;Bacteroidia;Bacteroidales;Paludibacteraceae;Paludibacter;Paludibacter propionicigenes	0	0	2	0	1	1	0	0	4
Bacteria;Bacteria_none;Bacteroidota;Bacteroidia;Bacteroidales;Dysgonomonadaceae;Dysgonomonas;Dysgonomonas macrotermitis	0	1	2	0	1	0	0	0	4
Bacteria;Bacteria_none;Actinomycetota;Actinomycetes;Bifidobacteriales;Bifidobacteriaceae;Bifidobacterium;Bifidobacterium porcinum	0	1	1	1	0	1	0	0	4
Bacteria;Bacteria_none;Pseudomonadota;Gammaproteobacteria;Enterobacterales;Enterobacteriaceae;Kluyvera;Kluyvera georgiana	0	0	0	4	0	0	0	0	4
Eukaryota;Fungi;Olpidiomycota;Olpidiomycetes;Olpidiales;Olpidiaceae;Olpidium;Olpidium brassicae	1	0	0	0	0	0	1	2	4
Viruses;Bamfordvirae;Nucleocytoviricota;Pokkesviricetes;Chitovirales;Poxviridae;Orthopoxvirus;Camelpox virus	0	0	0	0	1	0	1	2	4
Viruses;Heunggongvirae;Uroviricota;Caudoviricetes;Caudoviricetes_Incertae_sedis;Herelleviridae;Kayvirus;Kayvirus G1	0	0	1	0	2	0	0	1	4
Bacteria;Bacteria_none;Pseudomonadota;Gammaproteobacteria;Pseudomonadales;Pseudomonadaceae;Pseudomonas;Pseudomonas chlororaphis	1	1	0	1	1	0	0	0	4
Viruses;Orthornavirae;Negarnaviricota;Ellioviricetes;Bunyavirales;Tospoviridae;Orthotospovirus;Orthotospovirus capsicimaculaflavi	0	1	1	0	2	0	0	0	4
Bacteria;Bacteria_none;Pseudomonadota;Alphaproteobacteria;Rhodospirillales;Acetobacteraceae;Gluconacetobacter;Gluconacetobacter takamatsuzukensis	0	0	0	0	1	2	1	0	4
Bacteria;Bacteria_none;Pseudomonadota;Alphaproteobacteria;Rhodospirillales;Acetobacteraceae;Acidicaldus;Acidicaldus organivorans	1	0	0	1	1	0	1	0	4
Bacteria;Bacteria_none;Pseudomonadota;Alphaproteobacteria;Rhodospirillales;Acetobacteraceae;Acetobacter;Acetobacter garciniae	1	0	0	1	0	1	0	1	4
Bacteria;Bacteria_none;Pseudomonadota;Gammaproteobacteria;Enterobacterales;Erwiniaceae;Erwinia;Erwinia billingiae	0	0	1	0	0	0	1	2	4
Bacteria;Bacteria_none;Pseudomonadota;Alphaproteobacteria;Rhodospirillales;Acetobacteraceae;Gluconacetobacter;Gluconacetobacter asukensis	0	0	2	0	1	1	0	0	4
Bacteria;Bacteria_none;Actinomycetota;Actinomycetes;Bifidobacteriales;Bifidobacteriaceae;Bifidobacterium;Bifidobacterium avesanii	0	0	2	0	1	0	0	1	4
Bacteria;Bacteria_none;Pseudomonadota;Gammaproteobacteria;Enterobacterales;Erwiniaceae;Pantoea;[Erwinia] mediterraneensis	3	0	0	0	1	0	0	0	4
Bacteria;Bacteria_none;Pseudomonadota;Alphaproteobacteria;Rhodospirillales;Acetobacteraceae;Gluconacetobacter;Gluconacetobacter azotocaptans	0	0	0	0	0	2	1	1	4
Bacteria;Bacteria_none;Bacillota;Bacilli;Lactobacillales;Lactobacillaceae;Lactobacillus;Lactobacillus acetotolerans	2	0	0	1	0	0	0	0	3
Viruses;Heunggongvirae;Uroviricota;Caudoviricetes;Caudoviricetes_Incertae_sedis;Autographiviridae;Teetrevirus;Teetrevirus CFP1	0	0	0	0	3	0	0	0	3
Bacteria;Bacteria_none;Pseudomonadota;Gammaproteobacteria;Enterobacterales;Enterobacteriaceae;Citrobacter;Citrobacter freundii	0	1	1	0	0	1	0	0	3
Bacteria;Bacteria_none;Pseudomonadota;Betaproteobacteria;Neisseriales;Neisseriaceae;Neisseria;Neisseria animaloris	1	1	0	1	0	0	0	0	3
Bacteria;Bacteria_none;Pseudomonadota;Gammaproteobacteria;Enterobacterales;Enterobacteriaceae;Citrobacter;Citrobacter europaeus	0	1	1	1	0	0	0	0	3
Eukaryota;Fungi;Ascomycota;Dipodascomycetes;Dipodascales;Trichomonascaceae;Wickerhamiella;Wickerhamiella versatilis	0	0	0	0	1	0	0	2	3
Bacteria;Bacteria_none;Pseudomonadota;Alphaproteobacteria;Rhodospirillales;Acetobacteraceae;Gluconacetobacter;Gluconacetobacter johannae	1	0	0	0	0	1	0	1	3
Viruses;Heunggongvirae;Uroviricota;Caudoviricetes;Caudoviricetes_Incertae_sedis;Ackermannviridae;Taipeivirus;Taipeivirus magnus	0	0	0	0	1	0	0	2	3
Bacteria;Bacteria_none;Pseudomonadota;Gammaproteobacteria;Enterobacterales;Enterobacteriaceae;Enterobacter;Enterobacter bugandensis	0	0	1	0	0	1	0	1	3
Bacteria;Bacteria_none;Pseudomonadota;Alphaproteobacteria;Rhodospirillales;Acetobacteraceae;Gluconobacter;Gluconobacter cerinus	1	0	0	1	0	1	0	0	3
Bacteria;Bacteria_none;Pseudomonadota;Alphaproteobacteria;Hyphomicrobiales;Bartonellaceae;Bartonella;Bartonella chomelii	0	1	0	2	0	0	0	0	3
Bacteria;Bacteria_none;Pseudomonadota;Gammaproteobacteria;Enterobacterales;Erwiniaceae;Pantoea;Pantoea deleyi	0	0	1	0	0	2	0	0	3
Bacteria;Bacteria_none;Pseudomonadota;Gammaproteobacteria;Enterobacterales;Erwiniaceae;Pantoea;Pantoea dispersa	0	1	1	0	0	0	0	1	3
Bacteria;Bacteria_none;Pseudomonadota;Gammaproteobacteria;Enterobacterales;Enterobacteriaceae;Cedecea;Cedecea neteri	0	0	0	2	0	0	0	1	3
Bacteria;Bacteria_none;Bacteroidota;Bacteroidia;Bacteroidales;Porphyromonadaceae;Falsiporphyromonas;Falsiporphyromonas endometrii	0	0	2	0	0	0	0	1	3
Viruses;Orthornavirae;Pisuviricota;Pisoniviricetes;Picornavirales;Dicistroviridae;Aparavirus;Aparavirus apisacutum	0	0	1	0	0	0	2	0	3
Bacteria;Bacteria_none;Actinomycetota;Actinomycetes;Bifidobacteriales;Bifidobacteriaceae;Bifidobacterium;Bifidobacterium pseudocatenulatum	0	0	0	1	0	1	0	1	3
Bacteria;Bacteria_none;Pseudomonadota;Gammaproteobacteria;Enterobacterales;Erwiniaceae;Pantoea;Pantoea rodasii	0	0	1	0	0	1	0	1	3
Bacteria;Bacteria_none;Bacillota;Bacilli;Bacillales;Staphylococcaceae;Staphylococcus;Staphylococcus capitis	0	0	0	3	0	0	0	0	3
Bacteria;Bacteria_none;Actinomycetota;Actinomycetes;Bifidobacteriales;Bifidobacteriaceae;Bifidobacterium;Bifidobacterium mongoliense	0	1	0	0	1	1	0	0	3
Viruses;Viruses_Incertae_sedis;Viruses_Incertae_sedis;Naldaviricetes;Lefavirales;Nudiviridae;Gammanudivirus;Gammanudivirus pemonodonis	0	0	0	0	0	0	3	0	3
Bacteria;Bacteria_none;Pseudomonadota;Gammaproteobacteria;Enterobacterales;Enterobacteriaceae;Klebsiella;Klebsiella electrica	1	0	0	2	0	0	0	0	3
Bacteria;Bacteria_none;Pseudomonadota;Gammaproteobacteria;Enterobacterales;Enterobacteriaceae;Klebsiella;Klebsiella grimontii	0	0	0	3	0	0	0	0	3
Viruses;Viruses_Incertae_sedis;Viruses_Incertae_sedis;Viruses_Incertae_sedis;Viruses_Incertae_sedis;Polydnaviriformidae;Bracoviriform;Bracoviriform facetosae	0	0	0	0	3	0	0	0	3
Bacteria;Bacteria_none;Actinomycetota;Actinomycetes;Bifidobacteriales;Bifidobacteriaceae;Bifidobacterium;Bifidobacterium aerophilum	0	0	1	2	0	0	0	0	3
Bacteria;Bacteria_none;Pseudomonadota;Gammaproteobacteria;Enterobacterales;Enterobacteriaceae;Phytobacter;Phytobacter ursingii	2	1	0	0	0	0	0	0	3
Viruses;Heunggongvirae;Uroviricota;Caudoviricetes;Caudoviricetes_Incertae_sedis;Ackermannviridae;Taipeivirus;Taipeivirus menlow	0	3	0	0	0	0	0	0	3
Bacteria;Bacteria_none;Actinomycetota;Actinomycetes;Bifidobacteriales;Bifidobacteriaceae;Bifidobacterium;Bifidobacterium boum	0	0	2	1	0	0	0	0	3
Bacteria;Bacteria_none;Pseudomonadota;Gammaproteobacteria;Enterobacterales;Enterobacteriaceae;Shigella;Shigella sonnei	0	1	0	0	0	0	0	2	3
Bacteria;Bacteria_none;Pseudomonadota;Gammaproteobacteria;Enterobacterales;Erwiniaceae;Erwinia;Erwinia piriflorinigrans	0	0	0	3	0	0	0	0	3
Eukaryota;Fungi;Chytridiomycota;Chytridiomycetes;Spizellomycetales;Powellomycetaceae;Fimicolochytrium;Fimicolochytrium alabamae	1	0	1	0	0	0	1	0	3
Viruses;Heunggongvirae;Uroviricota;Caudoviricetes;Caudoviricetes_Incertae_sedis;Caudoviricetes_Incertae_sedis;Coventryvirus;Coventryvirus SP120	0	0	0	0	1	1	1	0	3
Bacteria;Bacteria_none;Actinomycetota;Actinomycetes;Bifidobacteriales;Bifidobacteriaceae;Bifidobacterium;Bifidobacterium leontopitheci	0	0	2	0	0	0	0	1	3
Bacteria;Bacteria_none;Pseudomonadota;Betaproteobacteria;Burkholderiales;Comamonadaceae;Comamonas;Comamonas sediminis	0	0	1	1	0	0	1	0	3
Viruses;Heunggongvirae;Uroviricota;Caudoviricetes;Caudoviricetes_Incertae_sedis;Straboviridae;Gualtarvirus;Gualtarvirus mp1	0	0	1	0	0	0	1	1	3
Viruses;Orthornavirae;Kitrinoviricota;Alsuviricetes;Martellivirales;Bromoviridae;Ilarvirus;Tobacco streak virus	0	3	0	0	0	0	0	0	3
Bacteria;Bacteria_none;Pseudomonadota;Gammaproteobacteria;Enterobacterales;Enterobacteriaceae;Raoultella;Raoultella terrigena	0	0	0	1	0	0	1	1	3
Bacteria;Bacteria_none;Bacteroidota;Flavobacteriia;Flavobacteriales;Weeksellaceae;Elizabethkingia;Elizabethkingia bruuniana	1	1	0	0	0	1	0	0	3
Bacteria;Bacteria_none;Actinomycetota;Actinomycetes;Propionibacteriales;Propionibacteriaceae;Cutibacterium;Cutibacterium acnes	0	0	0	3	0	0	0	0	3
Bacteria;Bacteria_none;Bacillota;Bacilli;Lactobacillales;Lactobacillaceae;Lactobacillus;Lactobacillus equicursoris	0	0	0	0	0	1	1	1	3
Bacteria;Bacteria_none;Bacillota;Bacilli;Lactobacillales;Lactobacillaceae;Lactobacillus;Lactobacillus hominis	0	2	1	0	0	0	0	0	3
Bacteria;Bacteria_none;Actinomycetota;Actinomycetes;Bifidobacteriales;Bifidobacteriaceae;Bifidobacterium;Bifidobacterium catenulatum	0	0	1	1	0	0	0	1	3
Viruses;Heunggongvirae;Uroviricota;Caudoviricetes;Caudoviricetes_Incertae_sedis;Peduoviridae;Dagavirus;Dagavirus ST13OXA48phi121	0	0	0	1	0	0	1	1	3
Bacteria;Bacteria_none;Pseudomonadota;Gammaproteobacteria;Enterobacterales;Erwiniaceae;Mixta;Mixta intestinalis	1	0	0	1	0	0	0	1	3
Bacteria;Bacteria_none;Pseudomonadota;Gammaproteobacteria;Enterobacterales;Enterobacteriaceae;Buttiauxella;Buttiauxella noackiae	0	0	0	2	0	0	1	0	3
Bacteria;Bacteria_none;Bacillota;Bacilli;Lactobacillales;Lactobacillaceae;Lactobacillus;Lactobacillus paragasseri	0	0	1	0	0	0	0	2	3
Bacteria;Bacteria_none;Pseudomonadota;Gammaproteobacteria;Enterobacterales;Erwiniaceae;Izhakiella;Izhakiella capsodis	3	0	0	0	0	0	0	0	3
Bacteria;Bacteria_none;Actinomycetota;Actinomycetes;Bifidobacteriales;Bifidobacteriaceae;Bifidobacterium;Bifidobacterium longum	0	1	0	1	0	0	0	1	3
Bacteria;Bacteria_none;Bacteroidota;Flavobacteriia;Flavobacteriales;Flavobacteriaceae;Prasinibacter;Prasinibacter corallicola	1	0	0	1	0	1	0	0	3
Viruses;Heunggongvirae;Uroviricota;Caudoviricetes;Caudoviricetes_Incertae_sedis;Autographiviridae;Teseptimavirus;Teseptimavirus HZP2	0	0	0	0	3	0	0	0	3
Bacteria;Bacteria_none;Pseudomonadota;Gammaproteobacteria;Enterobacterales;Enterobacteriaceae;Siccibacter;Siccibacter colletis	0	0	0	1	0	0	0	2	3
Viruses;Bamfordvirae;Nucleocytoviricota;Megaviricetes;Imitervirales;Mimiviridae;Fadolivirus;Fadolivirus algeromassiliense	0	0	0	0	0	2	0	0	2
Eukaryota;Fungi;Ascomycota;Pichiomycetes;Pichiales;Pichiaceae;Pichia;Pichia insulana	0	0	0	2	0	0	0	0	2
Bacteria;Bacteria_none;Pseudomonadota;Gammaproteobacteria;Enterobacterales;Enterobacteriaceae;Silvania;Silvania confinis	0	0	0	2	0	0	0	0	2
Bacteria;Bacteria_none;Pseudomonadota;Gammaproteobacteria;Enterobacterales;Erwiniaceae;Erwinia;Erwinia aphidicola	0	1	0	1	0	0	0	0	2
Bacteria;Bacteria_none;Pseudomonadota;Gammaproteobacteria;Enterobacterales;Morganellaceae;Providencia;Providencia rettgeri	0	0	0	0	0	0	0	2	2
Bacteria;Bacteria_none;Pseudomonadota;Gammaproteobacteria;Enterobacterales;Enterobacteriaceae;Kosakonia;Kosakonia oryzae	1	0	0	1	0	0	0	0	2
Bacteria;Bacteria_none;Pseudomonadota;Gammaproteobacteria;Enterobacterales;Erwiniaceae;Tatumella;Tatumella ptyseos	0	0	0	1	0	1	0	0	2
Bacteria;Bacteria_none;Pseudomonadota;Gammaproteobacteria;Enterobacterales;Enterobacteriaceae;Tenebrionicola;Tenebrionicola larvae	2	0	0	0	0	0	0	0	2
Bacteria;Bacteria_none;Pseudomonadota;Gammaproteobacteria;Enterobacterales;Enterobacteriaceae;Kosakonia;Kosakonia arachidis	0	1	0	0	0	0	0	1	2
Eukaryota;Fungi;Chytridiomycota;Chytridiomycetes;Rhizophydiales;Kappamycetaceae;Kappamyces;Kappamyces laurelensis	0	1	0	0	1	0	0	0	2
Bacteria;Bacteria_none;Pseudomonadota;Gammaproteobacteria;Enterobacterales;Erwiniaceae;Pantoea;Pantoea stewartii	0	0	0	0	0	1	0	1	2
Eukaryota;Fungi;Basidiomycota;Malasseziomycetes;Malasseziales;Malasseziaceae;Malassezia;Malassezia restricta	0	0	0	0	0	0	0	2	2
Bacteria;Bacteria_none;Pseudomonadota;Gammaproteobacteria;Enterobacterales;Enterobacteriaceae;Shigella;Shigella boydii	0	0	0	1	0	0	0	1	2
Bacteria;Bacteria_none;Pseudomonadota;Alphaproteobacteria;Hyphomicrobiales;Phyllobacteriaceae;Mesorhizobium;Mesorhizobium mediterraneum	0	0	0	0	0	1	0	1	2
Eukaryota;Fungi;Mucoromycota;Mortierellomycetes;Mortierellales;Mortierellaceae;Mortierella;Mortierella calciphila	0	0	0	0	0	1	0	1	2
Bacteria;Bacteria_none;Pseudomonadota;Gammaproteobacteria;Enterobacterales;Erwiniaceae;Erwinia;[Pantoea] beijingensis	1	0	0	0	1	0	0	0	2
Eukaryota;Fungi;Basidiomycota;Moniliellomycetes;Moniliellales;Moniliellaceae;Moniliella;Moniliella mellis	0	0	0	0	0	0	0	2	2
Bacteria;Bacteria_none;Actinomycetota;Actinomycetes;Bifidobacteriales;Bifidobacteriaceae;Bifidobacterium;Bifidobacterium santillanense	0	0	0	1	0	0	0	1	2
Bacteria;Bacteria_none;Bacillota;Bacilli;Lactobacillales;Lactobacillaceae;Lactobacillus;Lactobacillus crispatus	0	0	0	0	0	0	0	2	2
Bacteria;Bacteria_none;Actinomycetota;Actinomycetes;Bifidobacteriales;Bifidobacteriaceae;Bifidobacterium;Bifidobacterium tsurumiense	0	0	1	0	0	1	0	0	2
Bacteria;Bacteria_none;Actinomycetota;Actinomycetes;Bifidobacteriales;Bifidobacteriaceae;Parascardovia;Parascardovia denticolens	0	0	0	0	0	1	0	1	2
Bacteria;Bacteria_none;Pseudomonadota;Gammaproteobacteria;Enterobacterales;Enterobacteriaceae;Pseudocitrobacter;Pseudocitrobacter faecalis	1	0	0	0	0	0	0	1	2
Bacteria;Bacteria_none;Pseudomonadota;Gammaproteobacteria;Enterobacterales;Enterobacteriaceae;Pseudenterobacter;Pseudenterobacter timonensis	0	0	0	0	0	0	1	1	2
Bacteria;Bacteria_none;Bacillota;Bacilli;Lactobacillales;Lactobacillaceae;Lactobacillus;Lactobacillus delbrueckii	0	0	0	0	0	2	0	0	2
Bacteria;Bacteria_none;Pseudomonadota;Gammaproteobacteria;Enterobacterales;Morganellaceae;Morganella;Morganella psychrotolerans	0	0	0	2	0	0	0	0	2
Bacteria;Bacteria_none;Bacillota;Bacilli;Lactobacillales;Lactobacillaceae;Lactobacillus;Lactobacillus psittaci	2	0	0	0	0	0	0	0	2
Bacteria;Bacteria_none;Pseudomonadota;Gammaproteobacteria;Pasteurellales;Psittacicellaceae;Psittacicella;Psittacicella melopsittaci	0	0	0	1	0	0	0	1	2
Viruses;Bamfordvirae;Nucleocytoviricota;Megaviricetes;Imitervirales;Schizomimiviridae;Biavirus;Biavirus raunefjordenense	0	0	1	0	0	0	1	0	2
Bacteria;Bacteria_none;Pseudomonadota;Gammaproteobacteria;Oceanospirillales;Zooshikellaceae;Zooshikella;Zooshikella rubidus	0	0	0	0	0	2	0	0	2
Bacteria;Bacteria_none;Bacillota;Bacilli;Lactobacillales;Lactobacillaceae;Bombilactobacillus;Bombilactobacillus folatiphilus	0	0	1	0	0	0	0	1	2
Bacteria;Bacteria_none;Actinomycetota;Actinomycetes;Bifidobacteriales;Bifidobacteriaceae;Bifidobacterium;Bifidobacterium eulemuris	0	0	0	0	0	1	0	1	2
Bacteria;Bacteria_none;Pseudomonadota;Betaproteobacteria;Neisseriales;Neisseriaceae;Conchiformibius;Conchiformibius steedae	1	0	0	0	0	0	0	1	2
Bacteria;Bacteria_none;Pseudomonadota;Gammaproteobacteria;Pseudomonadales;Pseudomonadaceae;Pseudomonas;Pseudomonas qingdaonensis	0	1	0	0	0	1	0	0	2
Bacteria;Bacteria_none;Pseudomonadota;Betaproteobacteria;Neisseriales;Neisseriaceae;Neisseria;Neisseria cinerea	0	0	0	0	1	0	0	1	2
Bacteria;Bacteria_none;Bacillota;Bacilli;Lactobacillales;Lactobacillaceae;Fructobacillus;Fructobacillus pseudoficulneus	0	0	0	0	0	0	0	2	2
Bacteria;Bacteria_none;Pseudomonadota;Betaproteobacteria;Neisseriales;Neisseriaceae;Neisseria;Neisseria subflava	0	1	0	0	0	0	0	1	2
Bacteria;Bacteria_none;Pseudomonadota;Gammaproteobacteria;Pseudomonadales;Pseudomonadaceae;Pseudomonas;Pseudomonas tolaasii	0	0	0	2	0	0	0	0	2
Bacteria;Bacteria_none;Pseudomonadota;Betaproteobacteria;Neisseriales;Neisseriaceae;Neisseria;Neisseria zalophi	0	0	0	0	1	0	0	1	2
Bacteria;Bacteria_none;Pseudomonadota;Betaproteobacteria;Neisseriales;Neisseriaceae;Stenoxybacter;Stenoxybacter acetivorans	0	1	0	0	1	0	0	0	2
Bacteria;Bacteria_none;Bacillota;Bacilli;Lactobacillales;Lactobacillaceae;Fructobacillus;Fructobacillus tropaeoli	0	1	0	0	0	0	0	1	2
Bacteria;Bacteria_none;Pseudomonadota;Betaproteobacteria;Neisseriales;Neisseriaceae;Vitreoscilla;Vitreoscilla stercoraria	1	0	0	0	0	1	0	0	2
Bacteria;Bacteria_none;Pseudomonadota;Gammaproteobacteria;Aeromonadales;Aeromonadaceae;Aeromonas;Aeromonas caviae	0	2	0	0	0	0	0	0	2
Viruses;Heunggongvirae;Uroviricota;Caudoviricetes;Caudoviricetes_Incertae_sedis;Caudoviricetes_Incertae_sedis;Caudoviricetes_Incertae_sedis;Salmonella phage SSU5	0	0	0	0	0	1	0	1	2
Viruses;Heunggongvirae;Uroviricota;Caudoviricetes;Caudoviricetes_Incertae_sedis;Peduoviridae;Hpunavirus;Hpunavirus HP2	0	0	0	0	1	0	1	0	2
Bacteria;Bacteria_none;Bacillota;Bacilli;Lactobacillales;Lactobacillaceae;Bombilactobacillus;Bombilactobacillus apium	0	0	0	0	0	2	0	0	2
Viruses;Orthornavirae;Kitrinoviricota;Magsaviricetes;Nodamuvirales;Sinhaliviridae;Sinaivirus;Lake Sinai Virus SA1	0	0	0	0	2	0	0	0	2
Bacteria;Bacteria_none;Pseudomonadota;Alphaproteobacteria;Rhodospirillales;Acetobacteraceae;Neokomagataea;Neokomagataea tanensis	0	0	0	1	0	1	0	0	2
Bacteria;Bacteria_none;Pseudomonadota;Alphaproteobacteria;Rhodospirillales;Acetobacteraceae;Komagataeibacter;Komagataeibacter europaeus	1	0	0	1	0	0	0	0	2
Bacteria;Bacteria_none;Bacteroidota;Sphingobacteriia;Sphingobacteriales;Sphingobacteriaceae;Sphingobacterium;Sphingobacterium multivorum	1	0	0	0	0	0	0	1	2
Viruses;Orthornavirae;Kitrinoviricota;Magsaviricetes;Nodamuvirales;Sinhaliviridae;Sinaivirus;Lake Sinai virus 2	0	0	0	0	2	0	0	0	2
Bacteria;Bacteria_none;Pseudomonadota;Alphaproteobacteria;Rhodospirillales;Acetobacteraceae;Gluconacetobacter;Gluconacetobacter sacchari	0	0	0	0	2	0	0	0	2
Bacteria;Bacteria_none;Actinomycetota;Actinomycetes;Bifidobacteriales;Bifidobacteriaceae;Bifidobacterium;Bifidobacterium bombi	0	0	1	0	0	0	0	1	2
Bacteria;Bacteria_none;Pseudomonadota;Alphaproteobacteria;Hyphomicrobiales;Bartonellaceae;Bartonella;Bartonella ancashensis	0	0	0	1	0	0	0	1	2
Bacteria;Bacteria_none;Pseudomonadota;Alphaproteobacteria;Hyphomicrobiales;Bartonellaceae;Bartonella;Bartonella bovis	0	0	0	1	0	0	0	1	2
Bacteria;Bacteria_none;Pseudomonadota;Alphaproteobacteria;Hyphomicrobiales;Bartonellaceae;Bartonella;Bartonella grahamii	0	0	0	0	0	0	0	2	2
Bacteria;Bacteria_none;Actinomycetota;Actinomycetes;Bifidobacteriales;Bifidobacteriaceae;Bifidobacterium;Bifidobacterium bohemicum	0	0	0	1	0	1	0	0	2
Bacteria;Bacteria_none;Pseudomonadota;Gammaproteobacteria;Pasteurellales;Pasteurellaceae;Actinobacillus;Actinobacillus seminis	1	0	0	0	1	0	0	0	2
Viruses;Viruses_Incertae_sedis;Viruses_Incertae_sedis;Naldaviricetes;Lefavirales;Nudiviridae;Gammanudivirus;Gammanudivirus cracrangonis	0	0	0	0	1	0	0	1	2
Bacteria;Bacteria_none;Pseudomonadota;Gammaproteobacteria;Pasteurellales;Pasteurellaceae;Mannheimia;Mannheimia ruminalis	1	0	1	0	0	0	0	0	2
Bacteria;Bacteria_none;Pseudomonadota;Alphaproteobacteria;Hyphomicrobiales;Rhizobiaceae;Agrobacterium;Agrobacterium leguminum	0	1	1	0	0	0	0	0	2
Bacteria;Bacteria_none;Pseudomonadota;Gammaproteobacteria;Pseudomonadales;Pseudomonadaceae;Pseudomonas;Pseudomonas spelaei	0	0	0	1	1	0	0	0	2
Bacteria;Bacteria_none;Pseudomonadota;Gammaproteobacteria;Moraxellales;Moraxellaceae;Acinetobacter;Acinetobacter rudis	1	0	0	0	0	0	0	1	2
Bacteria;Bacteria_none;Pseudomonadota;Gammaproteobacteria;Aeromonadales;Aeromonadaceae;Aeromonas;Aeromonas taiwanensis	0	2	0	0	0	0	0	0	2
Bacteria;Bacteria_none;Pseudomonadota;Gammaproteobacteria;Enterobacterales;Enterobacteriaceae;Citrobacter;Citrobacter farmeri	0	0	0	0	0	0	2	0	2
Viruses;Bamfordvirae;Nucleocytoviricota;Pokkesviricetes;Chitovirales;Poxviridae;Poxviridae_Incertae_sedis;Diachasmimorpha entomopoxvirus	0	0	0	0	0	1	1	0	2
Bacteria;Bacteria_none;Actinomycetota;Actinomycetes;Bifidobacteriales;Bifidobacteriaceae;Bifidobacterium;Bifidobacterium moukalabense	0	0	0	0	0	0	0	2	2
Bacteria;Bacteria_none;Pseudomonadota;Gammaproteobacteria;Enterobacterales;Enterobacteriaceae;Franconibacter;Franconibacter daqui	0	0	0	1	0	0	0	1	2
Bacteria;Bacteria_none;Pseudomonadota;Gammaproteobacteria;Enterobacterales;Yersiniaceae;Serratia;Serratia bozhouensis	0	0	0	0	0	1	1	0	2
Bacteria;Bacteria_none;Bacteroidota;Bacteroidia;Bacteroidales;Dysgonomonadaceae;Petrimonas;Petrimonas sulfuriphila	0	0	1	0	0	0	0	1	2
Bacteria;Bacteria_none;Bacteroidota;Bacteroidia;Bacteroidales;Porphyromonadaceae;Porphyromonas;Porphyromonas cangingivalis	0	0	0	0	0	0	0	2	2
Viruses;Heunggongvirae;Uroviricota;Caudoviricetes;Caudoviricetes_Incertae_sedis;Ackermannviridae;Agtrevirus;Agtrevirus EM4	0	0	0	0	2	0	0	0	2
Bacteria;Bacteria_none;Pseudomonadota;Gammaproteobacteria;Enterobacterales;Yersiniaceae;Serratia;Serratia grimesii	1	1	0	0	0	0	0	0	2
Bacteria;Bacteria_none;Pseudomonadota;Gammaproteobacteria;Enterobacterales;Enterobacteriaceae;Enterobacter;Enterobacter chengduensis	1	0	0	0	0	1	0	0	2
Viruses;Heunggongvirae;Uroviricota;Caudoviricetes;Caudoviricetes_Incertae_sedis;Caudoviricetes_Incertae_sedis;Anamdongvirus;Anamdongvirus LBR48	0	0	0	0	1	0	0	1	2
Viruses;Heunggongvirae;Uroviricota;Caudoviricetes;Caudoviricetes_Incertae_sedis;Aliceevansviridae;Moineauvirus;Moineauvirus mv7A5	0	0	0	0	0	0	1	1	2
Bacteria;Bacteria_none;Pseudomonadota;Gammaproteobacteria;Enterobacterales;Enterobacteriaceae;Citrobacter;Citrobacter koseri	0	1	0	0	0	0	1	0	2
Eukaryota;Fungi;Ascomycota;Taphrinomycetes;Taphrinales;Taphrinaceae;Taphrina;Taphrina robinsoniana	0	0	0	0	0	0	1	1	2
Bacteria;Bacteria_none;Pseudomonadota;Gammaproteobacteria;Enterobacterales;Yersiniaceae;Serratia;Serratia rubidaea	0	1	0	1	0	0	0	0	2
Bacteria;Bacteria_none;Bacillota;Bacilli;Lactobacillales;Lactobacillaceae;Lacticaseibacillus;Lacticaseibacillus zhaodongensis	0	0	1	0	1	0	0	0	2
Bacteria;Bacteria_none;Pseudomonadota;Gammaproteobacteria;Enterobacterales;Enterobacteriaceae;Atlantibacter;Atlantibacter subterranea	0	0	2	0	0	0	0	0	2
Bacteria;Bacteria_none;Bacteroidota;Cytophagia;Cytophagales;Cyclobacteriaceae;Indibacter;Indibacter alkaliphilus	0	0	0	0	2	0	0	0	2
Bacteria;Bacteria_none;Pseudomonadota;Gammaproteobacteria;Enterobacterales;Enterobacteriaceae;Cedecea;Cedecea davisae	0	0	0	2	0	0	0	0	2
Viruses;Heunggongvirae;Uroviricota;Caudoviricetes;Caudoviricetes_Incertae_sedis;Autographiviridae;Teetrevirus;Teetrevirus SM93Y	0	0	0	0	2	0	0	0	2
Bacteria;Bacteria_none;Pseudomonadota;Gammaproteobacteria;Enterobacterales;Enterobacteriaceae;Citrobacter;Citrobacter cronae	0	1	0	1	0	0	0	0	2
Eukaryota;Fungi;Ascomycota;Sordariomycetes;Hypocreales;Nectriaceae;Lasionectria;Lasionectria krabiense	0	0	0	0	0	0	0	1	1
Eukaryota;Fungi;Ascomycota;Eurotiomycetes;Chaetothyriales;Herpotrichiellaceae;Exophiala;Exophiala jeanselmei	0	0	0	0	0	0	0	1	1
Bacteria;Bacteria_none;Actinomycetota;Actinomycetes;Micrococcales;Micrococcaceae;Rothia;Rothia dentocariosa	0	0	0	0	0	0	0	1	1
Bacteria;Bacteria_none;Actinomycetota;Actinomycetes;Mycobacteriales;Nocardiaceae;Rhodococcus;Rhodococcus qingshengii	0	0	0	0	0	1	0	0	1
Bacteria;Bacteria_none;Actinomycetota;Actinomycetes;Propionibacteriales;Propionibacteriaceae;Cutibacterium;Cutibacterium porci	0	0	0	0	0	0	0	1	1
Eukaryota;Fungi;Ascomycota;Lecanoromycetes;Ostropales;Stictidaceae;Cyanodermella;Cyanodermella oleoligni	0	0	0	0	0	0	0	1	1
Eukaryota;Fungi;Ascomycota;Ascomycota_Incertae_sedis;Ascomycota_Incertae_sedis;Ascomycota_Incertae_sedis;Saitoella;Saitoella complicata	0	0	0	1	0	0	0	0	1
Eukaryota;Fungi;Ascomycota;Dothideomycetes;Cladosporiales;Cladosporiaceae;Cladosporium;Cladosporium magnoliigena	0	0	1	0	0	0	0	0	1
Eukaryota;Fungi;Ascomycota;Sordariomycetes;Hypocreales;Cordycipitaceae;Cordyceps;Cordyceps cateniannulata	0	1	0	0	0	0	0	0	1
Eukaryota;Fungi;Ascomycota;Saccharomycetes;Phaffomycetales;Phaffomycetaceae;Barnettozyma;Barnettozyma pratensis	0	0	0	1	0	0	0	0	1
Bacteria;Bacteria_none;Pseudomonadota;Gammaproteobacteria;Pseudomonadales;Pseudomonadaceae;Pseudomonas;Pseudomonas brenneri	0	0	0	0	0	0	0	1	1
Eukaryota;Fungi;Ascomycota;Saccharomycetes;Phaffomycetales;Phaffomycetaceae;Phaffomyces;Phaffomyces antillensis	1	0	0	0	0	0	0	0	1
Eukaryota;Fungi;Ascomycota;Dipodascomycetes;Dipodascales;Trichomonascaceae;Starmerella;Starmerella floricola	0	0	0	0	0	0	0	1	1
Bacteria;Bacteria_none;Pseudomonadota;Gammaproteobacteria;Pseudomonadales;Pseudomonadaceae;Pseudomonas;Pseudomonas saudiphocaensis	0	0	0	0	0	1	0	0	1
Bacteria;Bacteria_none;Pseudomonadota;Gammaproteobacteria;Pseudomonadales;Pseudomonadaceae;Pseudomonas;Pseudomonas knackmussii	0	1	0	0	0	0	0	0	1
Eukaryota;Fungi;Ascomycota;Taphrinomycetes;Taphrinales;Taphrinaceae;Taphrina;Taphrina mirabilis	0	0	0	1	0	0	0	0	1
Eukaryota;Fungi;Ascomycota;Sordariomycetes;Hypocreales;Cordycipitaceae;Cordyceps;Cordyceps cateniobliqua	0	0	0	0	1	0	0	0	1
Eukaryota;Fungi;Ascomycota;Saccharomycetes;Saccharomycetales;Saccharomycetales_Incertae_sedis;Saccharomycetales_Incertae_sedis;[Candida] insectalens	0	0	0	0	0	0	0	1	1
Bacteria;Bacteria_none;Pseudomonadota;Gammaproteobacteria;Pseudomonadales;Pseudomonadaceae;Pseudomonas;Pseudomonas migulae	1	0	0	0	0	0	0	0	1
Bacteria;Bacteria_none;Pseudomonadota;Alphaproteobacteria;Hyphomicrobiales;Lichenihabitantaceae;Lichenibacterium;Lichenibacterium ramalinae	1	0	0	0	0	0	0	0	1
Eukaryota;Fungi;Basidiomycota;Malasseziomycetes;Malasseziales;Malasseziaceae;Malassezia;Malassezia japonica	0	0	0	0	0	0	0	1	1
Viruses;Heunggongvirae;Uroviricota;Caudoviricetes;Caudoviricetes_Incertae_sedis;Caudoviricetes_Incertae_sedis;Radostvirus;Radostvirus ev099	0	0	0	1	0	0	0	0	1
Viruses;Heunggongvirae;Uroviricota;Caudoviricetes;Caudoviricetes_Incertae_sedis;Autographiviridae;Teseptimavirus;Teseptimavirus HZ2R8	0	0	0	0	1	0	0	0	1
Viruses;Heunggongvirae;Uroviricota;Caudoviricetes;Caudoviricetes_Incertae_sedis;Caudoviricetes_Incertae_sedis;Astrithrvirus;Astrithrvirus astrithr	0	0	0	0	1	0	0	0	1
Bacteria;Bacteria_none;Actinomycetota;Actinomycetes;Bifidobacteriales;Bifidobacteriaceae;Bifidobacterium;Bifidobacterium miconisargentati	1	0	0	0	0	0	0	0	1
Viruses;Heunggongvirae;Uroviricota;Caudoviricetes;Caudoviricetes_Incertae_sedis;Caudoviricetes_Incertae_sedis;Caudoviricetes_Incertae_sedis;Enterobacteria phage mEp390	0	1	0	0	0	0	0	0	1
Viruses;Heunggongvirae;Uroviricota;Caudoviricetes;Caudoviricetes_Incertae_sedis;Caudoviricetes_Incertae_sedis;Caudoviricetes_Incertae_sedis;Enterococcus phage EF62phi	0	0	0	0	0	0	1	0	1
Bacteria;Bacteria_none;Actinomycetota;Actinomycetes;Bifidobacteriales;Bifidobacteriaceae;Bifidobacterium;Bifidobacterium merycicum	0	0	0	0	0	0	0	1	1
Viruses;Heunggongvirae;Uroviricota;Caudoviricetes;Caudoviricetes_Incertae_sedis;Caudoviricetes_Incertae_sedis;Caudoviricetes_Incertae_sedis;Lactobacillus phage phiadh	0	0	0	0	1	0	0	0	1
Viruses;Heunggongvirae;Uroviricota;Caudoviricetes;Caudoviricetes_Incertae_sedis;Caudoviricetes_Incertae_sedis;Cobrasixvirus;Cobrasixvirus cobrasix	0	0	0	0	0	0	0	1	1
Viruses;Heunggongvirae;Uroviricota;Caudoviricetes;Caudoviricetes_Incertae_sedis;Caudoviricetes_Incertae_sedis;Glaedevirus;Glaedevirus gv2H10	0	0	0	0	0	0	0	1	1
Viruses;Heunggongvirae;Uroviricota;Caudoviricetes;Caudoviricetes_Incertae_sedis;Caudoviricetes_Incertae_sedis;Nochtlivirus;Nochtlivirus mEp235	0	1	0	0	0	0	0	0	1
Bacteria;Bacteria_none;Actinomycetota;Actinomycetes;Bifidobacteriales;Bifidobacteriaceae;Bifidobacterium;Bifidobacterium goeldii	0	1	0	0	0	0	0	0	1
Viruses;Heunggongvirae;Uroviricota;Caudoviricetes;Caudoviricetes_Incertae_sedis;Caudoviricetes_Incertae_sedis;Punavirus;Punavirus RCS47	0	1	0	0	0	0	0	0	1
Viruses;Heunggongvirae;Uroviricota;Caudoviricetes;Caudoviricetes_Incertae_sedis;Caudoviricetes_Incertae_sedis;Saikungvirus;Saikungvirus HK633	0	0	0	0	0	0	0	1	1
Eukaryota;Fungi;Basidiomycota;Malasseziomycetes;Malasseziales;Malasseziaceae;Malassezia;Malassezia pachydermatis	0	0	0	0	0	0	0	1	1
Viruses;Heunggongvirae;Uroviricota;Caudoviricetes;Caudoviricetes_Incertae_sedis;Caudoviricetes_Incertae_sedis;Salmondvirus;Salmondvirus JA29	0	0	0	1	0	0	0	0	1
Viruses;Heunggongvirae;Uroviricota;Caudoviricetes;Caudoviricetes_Incertae_sedis;Herelleviridae;Shalavirus;Shalavirus Shbh1	0	0	0	0	1	0	0	0	1
Viruses;Heunggongvirae;Uroviricota;Caudoviricetes;Caudoviricetes_Incertae_sedis;Peduoviridae;Hpunavirus;Hpunavirus HP1	0	0	0	0	0	0	1	0	1
Viruses;Heunggongvirae;Uroviricota;Caudoviricetes;Caudoviricetes_Incertae_sedis;Peduoviridae;Vimunumvirus;Vimunumvirus ST147VIM1phi71	0	1	0	0	0	0	0	0	1
Bacteria;Bacteria_none;Actinomycetota;Actinomycetes;Bifidobacteriales;Bifidobacteriaceae;Bifidobacterium;Bifidobacterium dolichotidis	0	0	0	0	0	0	0	1	1
Bacteria;Bacteria_none;Actinomycetota;Actinomycetes;Bifidobacteriales;Bifidobacteriaceae;Bifidobacterium;Bifidobacterium dentium	0	0	0	0	0	1	0	0	1
Bacteria;Bacteria_none;Actinomycetota;Actinomycetes;Bifidobacteriales;Bifidobacteriaceae;Bifidobacterium;Bifidobacterium breve	0	0	0	0	0	0	0	1	1
Viruses;Orthornavirae;Lenarviricota;Leviviricetes;Timlovirales;Steitzviridae;Gihfavirus;Gihfavirus pelohabitans	0	0	1	0	0	0	0	0	1
Bacteria;Bacteria_none;Actinomycetota;Actinomycetes;Bifidobacteriales;Bifidobacteriaceae;Bifidobacterium;Bifidobacterium biavatii	0	0	0	0	0	0	0	1	1
Viruses;Orthornavirae;Pisuviricota;Pisoniviricetes;Picornavirales;Iflaviridae;Iflavirus;Iflavirus ectobliquae	0	0	1	0	0	0	0	0	1
Viruses;Shotokuvirae;Cressdnaviricota;Repensiviricetes;Geplafuvirales;Genomoviridae;Gemycircularvirus;Gemycircularvirus oxcor1	0	0	0	1	0	0	0	0	1
Bacteria;Bacteria_none;Actinomycetota;Actinomycetes;Bifidobacteriales;Bifidobacteriaceae;Bifidobacterium;Bifidobacterium animalis	0	0	1	0	0	0	0	0	1
Viruses;Heunggongvirae;Uroviricota;Caudoviricetes;Caudoviricetes_Incertae_sedis;Autographiviridae;Teetrevirus;Teetrevirus SGJL2	0	0	0	0	1	0	0	0	1
Viruses;Heunggongvirae;Uroviricota;Caudoviricetes;Caudoviricetes_Incertae_sedis;Autographiviridae;Teetrevirus;Teetrevirus KPN3	0	0	0	0	1	0	0	0	1
Viruses;Heunggongvirae;Uroviricota;Caudoviricetes;Caudoviricetes_Incertae_sedis;Autographiviridae;Teetrevirus;Teetrevirus ECA2	0	0	0	0	1	0	0	0	1
Viruses;Heunggongvirae;Uroviricota;Caudoviricetes;Caudoviricetes_Incertae_sedis;Autographiviridae;Teetrevirus;Teetrevirus AP5	0	0	0	0	1	0	0	0	1
Eukaryota;Fungi;Basidiomycota;Microbotryomycetes;Sporidiobolales;Sporidiobolaceae;Rhodosporidiobolus;Rhodosporidiobolus poonsookiae	0	0	0	0	0	1	0	0	1
Eukaryota;Fungi;Basidiomycota;Pucciniomycetes;Pucciniales;Pucciniastraceae;Pucciniastrum;Pucciniastrum myosotidii	0	0	0	0	1	0	0	0	1
Eukaryota;Fungi;Chytridiomycota;Chytridiomycetes;Lobulomycetales;Lobulomycetaceae;Clydaea;Clydaea vesicula	0	1	0	0	0	0	0	0	1
Eukaryota;Fungi;Chytridiomycota;Chytridiomycetes;Lobulomycetales;Lobulomycetaceae;Lobulomyces;Lobulomyces angularis	0	0	0	0	1	0	0	0	1
Eukaryota;Fungi;Chytridiomycota;Chytridiomycetes;Spizellomycetales;Powellomycetaceae;Geranomyces;Geranomyces michiganensis	0	0	0	0	0	1	0	0	1
Eukaryota;Fungi;Chytridiomycota;Chytridiomycetes;Spizellomycetales;Powellomycetaceae;Thoreauomyces;Thoreauomyces humboldtii	0	0	0	0	0	1	0	0	1
Bacteria;Bacteria_none;Actinomycetota;Actinomycetes;Micrococcales;Microbacteriaceae;Leifsonia;Leifsonia naganoensis	0	0	0	1	0	0	0	0	1
Eukaryota;Fungi;Chytridiomycota;Chytridiomycetes;Synchytriales;Synchytriaceae;Synchytrium;Synchytrium microbalum	0	1	0	0	0	0	0	0	1
Eukaryota;Fungi;Cryptomycota;Cryptomycota_Incertae_sedis;Cryptomycota_Incertae_sedis;Cryptomycota_Incertae_sedis;Rozella;Rozella allomycis	0	0	0	0	0	1	0	0	1
Bacteria;Bacteria_none;Actinomycetota;Actinomycetes;Bifidobacteriales;Bifidobacteriaceae;Pseudoscardovia;Pseudoscardovia radai	0	0	1	0	0	0	0	0	1
Bacteria;Bacteria_none;Actinomycetota;Actinomycetes;Bifidobacteriales;Bifidobacteriaceae;Bifidobacterium;Bifidobacterium vespertilionis	0	0	0	1	0	0	0	0	1
Bacteria;Bacteria_none;Actinomycetota;Actinomycetes;Bifidobacteriales;Bifidobacteriaceae;Bifidobacterium;Bifidobacterium psychraerophilum	0	0	1	0	0	0	0	0	1
Viruses;Bamfordvirae;Nucleocytoviricota;Megaviricetes;Algavirales;Phycodnaviridae;Chlorovirus;Paramecium bursaria Chlorella virus NYs1	0	0	0	0	1	0	0	0	1
Bacteria;Bacteria_none;Actinomycetota;Actinomycetes;Bifidobacteriales;Bifidobacteriaceae;Bifidobacterium;Bifidobacterium pseudolongum	0	0	1	0	0	0	0	0	1
Viruses;Bamfordvirae;Nucleocytoviricota;Megaviricetes;Imitervirales;Mimiviridae;Cotonvirus;Cotonvirus japonicum	0	0	0	0	1	0	0	0	1
Viruses;Bamfordvirae;Nucleocytoviricota;Megaviricetes;Imitervirales;Mimiviridae;Megavirus;Megavirus chilense	0	0	0	0	0	0	1	0	1
Viruses;Bamfordvirae;Nucleocytoviricota;Megaviricetes;Imitervirales;Mimiviridae;Rheavirus;Rheavirus sinusmexicani	0	1	0	0	0	0	0	0	1
Bacteria;Bacteria_none;Actinomycetota;Actinomycetes;Bifidobacteriales;Bifidobacteriaceae;Bifidobacterium;Bifidobacterium pongonis	0	1	0	0	0	0	0	0	1
Bacteria;Bacteria_none;Actinomycetota;Actinomycetes;Bifidobacteriales;Bifidobacteriaceae;Bifidobacterium;Bifidobacterium phasiani	0	0	1	0	0	0	0	0	1
Bacteria;Bacteria_none;Actinomycetota;Actinomycetes;Bifidobacteriales;Bifidobacteriaceae;Bifidobacterium;Bifidobacterium myosotis	0	0	0	0	0	1	0	0	1
Bacteria;Bacteria_none;Pseudomonadota;Gammaproteobacteria;Pasteurellales;Psittacicellaceae;Psittacicella;Psittacicella hinzii	0	0	0	0	0	1	0	0	1
Viruses;Heunggongvirae;Peploviricota;Herviviricetes;Herpesvirales;Orthoherpesviridae;Orthoherpesviridae_Incertae_sedis;Eptesicus fuscus gammaherpesvirus	0	0	0	0	0	0	1	0	1
Viruses;Heunggongvirae;Peploviricota;Herviviricetes;Herpesvirales;Orthoherpesviridae;Simplexvirus;Simplexvirus atelinealpha1	1	0	0	0	0	0	0	0	1
Viruses;Heunggongvirae;Uroviricota;Caudoviricetes;Caudoviricetes_Incertae_sedis;Ackermannviridae;Agtrevirus;Agtrevirus MK13	0	0	0	0	1	0	0	0	1
Viruses;Heunggongvirae;Uroviricota;Caudoviricetes;Caudoviricetes_Incertae_sedis;Aliceevansviridae;Moineauvirus;Moineauvirus CHPC950	0	0	0	0	0	1	0	0	1
Viruses;Bamfordvirae;Nucleocytoviricota;Pokkesviricetes;Chitovirales;Poxviridae;Orthopoxvirus;Taterapox virus	0	0	0	0	1	0	0	0	1
Bacteria;Bacteria_none;Pseudomonadota;Gammaproteobacteria;Enterobacterales;Erwiniaceae;Pantoea;Pantoea endophytica	0	0	0	1	0	0	0	0	1
Bacteria;Bacteria_none;Pseudomonadota;Gammaproteobacteria;Pasteurellales;Pasteurellaceae;Ursidibacter;Ursidibacter maritimus	1	0	0	0	0	0	0	0	1
Bacteria;Bacteria_none;Pseudomonadota;Gammaproteobacteria;Enterobacterales;Enterobacteriaceae;Buttiauxella;Buttiauxella izardii	0	0	0	0	0	0	0	1	1
Bacteria;Bacteria_none;Pseudomonadota;Gammaproteobacteria;Enterobacterales;Bruguierivoracaceae;Sodalis;Sodalis ligni	0	0	0	0	1	0	0	0	1
Bacteria;Bacteria_none;Pseudomonadota;Gammaproteobacteria;Alteromonadales;Alteromonadaceae;Pseudobowmanella;Pseudobowmanella zhangzhouensis	0	0	0	0	0	1	0	0	1
Bacteria;Bacteria_none;Pseudomonadota;Gammaproteobacteria;Aeromonadales;Succinivibrionaceae;Ruminobacter;Ruminobacter amylophilus	0	0	0	0	0	1	0	0	1
Bacteria;Bacteria_none;Pseudomonadota;Gammaproteobacteria;Aeromonadales;Aeromonadaceae;Aeromonas;Aeromonas salmonicida	0	1	0	0	0	0	0	0	1
Bacteria;Bacteria_none;Pseudomonadota;Gammaproteobacteria;Aeromonadales;Aeromonadaceae;Aeromonas;Aeromonas rivuli	0	1	0	0	0	0	0	0	1
Bacteria;Bacteria_none;Pseudomonadota;Gammaproteobacteria;Aeromonadales;Aeromonadaceae;Aeromonas;Aeromonas popoffii	0	1	0	0	0	0	0	0	1
Bacteria;Bacteria_none;Pseudomonadota;Gammaproteobacteria;Aeromonadales;Aeromonadaceae;Aeromonas;Aeromonas piscicola	0	1	0	0	0	0	0	0	1
Bacteria;Bacteria_none;Pseudomonadota;Gammaproteobacteria;Aeromonadales;Aeromonadaceae;Aeromonas;Aeromonas molluscorum	0	1	0	0	0	0	0	0	1
Bacteria;Bacteria_none;Pseudomonadota;Gammaproteobacteria;Aeromonadales;Aeromonadaceae;Aeromonas;Aeromonas jandaei	0	1	0	0	0	0	0	0	1
Bacteria;Bacteria_none;Bacteroidota;Flavobacteriia;Flavobacteriales;Weeksellaceae;Chryseobacterium;Chryseobacterium aureum	0	0	0	1	0	0	0	0	1
Bacteria;Bacteria_none;Pseudomonadota;Betaproteobacteria;Nitrosomonadales;Methylophilaceae;Methylobacillus;Methylobacillus methanolivorans	1	0	0	0	0	0	0	0	1
Bacteria;Bacteria_none;Pseudomonadota;Betaproteobacteria;Nitrosomonadales;Methylophilaceae;Methylobacillus;Methylobacillus flagellatus	0	1	0	0	0	0	0	0	1
Bacteria;Bacteria_none;Bacteroidota;Flavobacteriia;Flavobacteriales;Weeksellaceae;Chryseobacterium;Chryseobacterium formosus	0	0	0	0	0	1	0	0	1
Bacteria;Bacteria_none;Bacteroidota;Flavobacteriia;Flavobacteriales;Weeksellaceae;Chryseobacterium;Chryseobacterium geocarposphaerae	0	0	0	0	1	0	0	0	1
Bacteria;Bacteria_none;Bacteroidota;Flavobacteriia;Flavobacteriales;Weeksellaceae;Chryseobacterium;Chryseobacterium polytrichastri	0	0	0	0	0	1	0	0	1
Bacteria;Bacteria_none;Pseudomonadota;Gammaproteobacteria;Enterobacterales;Enterobacteriaceae;Buttiauxella;Buttiauxella agrestis	0	0	1	0	0	0	0	0	1
Bacteria;Bacteria_none;Pseudomonadota;Gammaproteobacteria;Enterobacterales;Enterobacteriaceae;Buttiauxella;Buttiauxella massiliensis	0	0	0	0	0	0	0	1	1
Bacteria;Bacteria_none;Bacillota;Bacilli;Bacillales;Staphylococcaceae;Staphylococcus;Staphylococcus caprae	0	0	0	1	0	0	0	0	1
Bacteria;Bacteria_none;Bacteroidota;Flavobacteriia;Flavobacteriales;Flavobacteriaceae;Flavobacterium;Flavobacterium niveum	0	0	0	1	0	0	0	0	1
Bacteria;Bacteria_none;Pseudomonadota;Gammaproteobacteria;Enterobacterales;Enterobacteriaceae;Franconibacter;Franconibacter pulveris	1	0	0	0	0	0	0	0	1
Bacteria;Bacteria_none;Pseudomonadota;Gammaproteobacteria;Enterobacterales;Enterobacteriaceae;Franconibacter;Franconibacter helveticus	1	0	0	0	0	0	0	0	1
Bacteria;Bacteria_none;Bacteroidota;Bacteroidia;Bacteroidales;Dysgonomonadaceae;Dysgonomonas;Dysgonomonas alginatilytica	0	0	0	0	0	1	0	0	1
Bacteria;Bacteria_none;Pseudomonadota;Gammaproteobacteria;Enterobacterales;Enterobacteriaceae;Escherichia;Escherichia albertii	0	0	0	1	0	0	0	0	1
Bacteria;Bacteria_none;Actinomycetota;Actinomycetes;Bifidobacteriales;Bifidobacteriaceae;Bifidobacterium;Bifidobacterium adolescentis	0	0	0	1	0	0	0	0	1
Bacteria;Bacteria_none;Bacteroidota;Bacteroidia;Bacteroidales;Dysgonomonadaceae;Proteiniphilum;Proteiniphilum acetatigenes	0	0	1	0	0	0	0	0	1
Bacteria;Bacteria_none;Bacteroidota;Bacteroidia;Bacteroidales;Porphyromonadaceae;Porphyromonas;Porphyromonas crevioricanis	0	0	0	1	0	0	0	0	1
Bacteria;Bacteria_none;Bacteroidota;Bacteroidia;Bacteroidales;Porphyromonadaceae;Porphyromonas;Porphyromonas somerae	0	0	0	0	0	0	0	1	1
Bacteria;Bacteria_none;Bacteroidota;Bacteroidia;Bacteroidales;Tannerellaceae;Parabacteroides;Parabacteroides chongii	0	0	0	1	0	0	0	0	1
Bacteria;Bacteria_none;Pseudomonadota;Gammaproteobacteria;Enterobacterales;Enterobacteriaceae;Citrobacter;Citrobacter youngae	0	0	1	0	0	0	0	0	1
Bacteria;Bacteria_none;Pseudomonadota;Gammaproteobacteria;Enterobacterales;Enterobacteriaceae;Citrobacter;Citrobacter werkmanii	0	1	0	0	0	0	0	0	1
Bacteria;Bacteria_none;Pseudomonadota;Gammaproteobacteria;Enterobacterales;Enterobacteriaceae;Citrobacter;Citrobacter sedlakii	0	1	0	0	0	0	0	0	1
Bacteria;Bacteria_none;Pseudomonadota;Gammaproteobacteria;Enterobacterales;Enterobacteriaceae;Citrobacter;Citrobacter pasteurii	1	0	0	0	0	0	0	0	1
Bacteria;Bacteria_none;Bacteroidota;Bacteroidia;Bacteroidales;Tannerellaceae;Tannerella;Tannerella serpentiformis	0	0	0	0	0	0	0	1	1
Bacteria;Bacteria_none;Bacteroidota;Bacteroidia;Marinilabiliales;Marinilabiliaceae;Natronoflexus;Natronoflexus pectinivorans	0	0	1	0	0	0	0	0	1
Bacteria;Bacteria_none;Pseudomonadota;Betaproteobacteria;Neisseriales;Neisseriaceae;Neisseria;Neisseria shayeganii	0	0	0	0	0	1	0	0	1
Bacteria;Bacteria_none;Pseudomonadota;Betaproteobacteria;Neisseriales;Neisseriaceae;Neisseria;Neisseria mucosa	0	0	0	0	1	0	0	0	1
Bacteria;Bacteria_none;Pseudomonadota;Betaproteobacteria;Neisseriales;Neisseriaceae;Neisseria;Neisseria meningitidis	1	0	0	0	0	0	0	0	1
Bacteria;Bacteria_none;Pseudomonadota;Betaproteobacteria;Neisseriales;Neisseriaceae;Neisseria;Neisseria flavescens	0	0	0	0	1	0	0	0	1
Bacteria;Bacteria_none;Planctomycetota;Planctomycetia;Gemmatales;Gemmataceae;Fimbriiglobus;Fimbriiglobus ruber	0	0	0	0	0	0	0	1	1
Bacteria;Bacteria_none;Pseudomonadota;Alphaproteobacteria;Rhodospirillales;Acetobacteraceae;Gluconobacter;Gluconobacter cerevisiae	0	0	0	1	0	0	0	0	1
Bacteria;Bacteria_none;Pseudomonadota;Alphaproteobacteria;Hyphomicrobiales;Aurantimonadaceae;Aureimonas;Aureimonas altamirensis	0	0	0	1	0	0	0	0	1
Bacteria;Bacteria_none;Pseudomonadota;Alphaproteobacteria;Hyphomicrobiales;Bartonellaceae;Bartonella;Bartonella capreoli	0	0	0	1	0	0	0	0	1
Bacteria;Bacteria_none;Pseudomonadota;Alphaproteobacteria;Hyphomicrobiales;Bartonellaceae;Bartonella;Bartonella quintana	1	0	0	0	0	0	0	0	1
Bacteria;Bacteria_none;Pseudomonadota;Alphaproteobacteria;Hyphomicrobiales;Bartonellaceae;Bartonella;Bartonella schoenbuchensis	0	0	0	1	0	0	0	0	1
Bacteria;Bacteria_none;Pseudomonadota;Alphaproteobacteria;Hyphomicrobiales;Bartonellaceae;Bartonella;Bartonella silvatica	0	0	1	0	0	0	0	0	1
Bacteria;Bacteria_none;Pseudomonadota;Alphaproteobacteria;Rhodospirillales;Acetobacteraceae;Acetobacter;Acetobacter nitrogenifigens	1	0	0	0	0	0	0	0	1
Bacteria;Bacteria_none;Pseudomonadota;Alphaproteobacteria;Hyphomicrobiales;Rhizobiaceae;Rhizobium;Rhizobium sphaerophysae	0	1	0	0	0	0	0	0	1
Bacteria;Bacteria_none;Pseudomonadota;Alphaproteobacteria;Hyphomicrobiales;Rhizobiaceae;Rhizobium;Rhizobium nepotum	0	1	0	0	0	0	0	0	1
Bacteria;Bacteria_none;Pseudomonadota;Alphaproteobacteria;Hyphomicrobiales;Brucellaceae;Pseudochrobactrum;Pseudochrobactrum saccharolyticum	0	1	0	0	0	0	0	0	1
Bacteria;Bacteria_none;Pseudomonadota;Alphaproteobacteria;Hyphomicrobiales;Rhizobiaceae;Rhizobium;Rhizobium halophytocola	0	0	1	0	0	0	0	0	1
Bacteria;Bacteria_none;Pseudomonadota;Alphaproteobacteria;Hyphomicrobiales;Rhizobiaceae;Rhizobium;Rhizobium glycinendophyticum	0	0	0	0	0	0	0	1	1
Bacteria;Bacteria_none;Pseudomonadota;Alphaproteobacteria;Hyphomicrobiales;Lichenihabitantaceae;Lichenibacterium;Lichenibacterium minor	1	0	0	0	0	0	0	0	1
Bacteria;Bacteria_none;Pseudomonadota;Alphaproteobacteria;Hyphomicrobiales;Phyllobacteriaceae;Phyllobacterium;Phyllobacterium ifriqiyense	0	0	0	0	0	0	0	1	1
Bacteria;Bacteria_none;Mycoplasmatota;Mollicutes;Entomoplasmatales;Spiroplasmataceae;Spiroplasma;Spiroplasma diabroticae	0	0	1	0	0	0	0	0	1
Bacteria;Bacteria_none;Bacteroidota;Sphingobacteriia;Sphingobacteriales;Sphingobacteriaceae;Sphingobacterium;Sphingobacterium athyrii	0	1	0	0	0	0	0	0	1
Bacteria;Bacteria_none;Bacteroidota;Flavobacteriia;Flavobacteriales;Weeksellaceae;Weeksella;Weeksella massiliensis	0	0	1	0	0	0	0	0	1
Bacteria;Bacteria_none;Pseudomonadota;Betaproteobacteria;Neisseriales;Chromobacteriaceae;Paludibacterium;Paludibacterium paludis	0	0	0	0	1	0	0	0	1
Bacteria;Bacteria_none;Pseudomonadota;Betaproteobacteria;Neisseriales;Neisseriaceae;Neisseria;Neisseria dumasiana	0	0	0	0	0	0	1	0	1
Bacteria;Bacteria_none;Pseudomonadota;Betaproteobacteria;Neisseriales;Neisseriaceae;Neisseria;Neisseria dentiae	0	1	0	0	0	0	0	0	1
Bacteria;Bacteria_none;Pseudomonadota;Betaproteobacteria;Neisseriales;Neisseriaceae;Neisseria;Neisseria chenwenguii	0	0	0	0	0	1	0	0	1
Bacteria;Bacteria_none;Pseudomonadota;Betaproteobacteria;Neisseriales;Neisseriaceae;Neisseria;Neisseria bacilliformis	0	1	0	0	0	0	0	0	1
Bacteria;Bacteria_none;Pseudomonadota;Betaproteobacteria;Neisseriales;Neisseriaceae;Kingella;Kingella kingae	0	0	0	0	1	0	0	0	1
Bacteria;Bacteria_none;Pseudomonadota;Betaproteobacteria;Neisseriales;Neisseriaceae;Conchiformibius;Conchiformibius kuhniae	0	1	0	0	0	0	0	0	1
Bacteria;Bacteria_none;Pseudomonadota;Betaproteobacteria;Neisseriales;Chromobacteriaceae;Chromobacterium;Chromobacterium paludis	0	0	0	0	0	0	1	0	1
Bacteria;Bacteria_none;Bacteroidota;Flavobacteriia;Flavobacteriales;Weeksellaceae;Ornithobacterium;Ornithobacterium rhinotracheale	0	0	0	0	1	0	0	0	1
Bacteria;Bacteria_none;Pseudomonadota;Betaproteobacteria;Neisseriales;Aquaspirillaceae;Microvirgula;Microvirgula curvata	0	0	0	1	0	0	0	0	1
Bacteria;Bacteria_none;Pseudomonadota;Betaproteobacteria;Burkholderiales;Comamonadaceae;Delftia;Delftia lacustris	0	0	0	1	0	0	0	0	1
Bacteria;Bacteria_none;Pseudomonadota;Betaproteobacteria;Burkholderiales;Comamonadaceae;Comamonas;Comamonas aquatilis	0	0	0	0	1	0	0	0	1
Bacteria;Bacteria_none;Pseudomonadota;Betaproteobacteria;Burkholderiales;Burkholderiaceae;Ralstonia;Ralstonia solanacearum	0	1	0	0	0	0	0	0	1
Bacteria;Bacteria_none;Pseudomonadota;Alphaproteobacteria;Rickettsiales;Rickettsiaceae;Occidentia;Occidentia massiliensis	0	0	0	0	0	1	0	0	1
Bacteria;Bacteria_none;Pseudomonadota;Alphaproteobacteria;Rhodospirillales;Acetobacteraceae;Swingsia;Swingsia samuiensis	0	0	0	1	0	0	0	0	1
Bacteria;Bacteria_none;Bacteroidota;Bacteroidia;Bacteroidales;Bacteroidaceae;Bacteroides;Bacteroides intestinalis	0	0	1	0	0	0	0	0	1
Bacteria;Bacteria_none;Bacillota;Tissierellia;Tissierellales;Peptoniphilaceae;Anaerococcus;Anaerococcus nagyae	0	0	0	1	0	0	0	0	1
Bacteria;Bacteria_none;Pseudomonadota;Gammaproteobacteria;Enterobacterales;Enterobacteriaceae;Klebsiella;Klebsiella africana	0	0	0	1	0	0	0	0	1
Bacteria;Bacteria_none;Pseudomonadota;Gammaproteobacteria;Enterobacterales;Erwiniaceae;Pantoea;Pantoea rwandensis	0	0	0	1	0	0	0	0	1
Bacteria;Bacteria_none;Pseudomonadota;Gammaproteobacteria;Enterobacterales;Pectobacteriaceae;Pectobacterium;Pectobacterium punjabense	0	1	0	0	0	0	0	0	1
Bacteria;Bacteria_none;Pseudomonadota;Gammaproteobacteria;Enterobacterales;Pectobacteriaceae;Pectobacterium;Pectobacterium parmentieri	0	0	0	1	0	0	0	0	1
Bacteria;Bacteria_none;Pseudomonadota;Gammaproteobacteria;Enterobacterales;Pectobacteriaceae;Pectobacterium;Pectobacterium carotovorum	0	0	0	1	0	0	0	0	1
Bacteria;Bacteria_none;Pseudomonadota;Gammaproteobacteria;Enterobacterales;Pectobacteriaceae;Pectobacterium;Pectobacterium brasiliense	0	0	0	1	0	0	0	0	1
Bacteria;Bacteria_none;Pseudomonadota;Gammaproteobacteria;Enterobacterales;Pectobacteriaceae;Pectobacterium;Pectobacterium actinidiae	0	0	0	1	0	0	0	0	1
Bacteria;Bacteria_none;Pseudomonadota;Gammaproteobacteria;Enterobacterales;Pectobacteriaceae;Lonsdalea;Lonsdalea iberica	0	0	0	0	0	0	0	1	1
Bacteria;Bacteria_none;Pseudomonadota;Gammaproteobacteria;Enterobacterales;Morganellaceae;Xenorhabdus;Xenorhabdus szentirmaii	1	0	0	0	0	0	0	0	1
Bacteria;Bacteria_none;Pseudomonadota;Gammaproteobacteria;Enterobacterales;Morganellaceae;Xenorhabdus;Xenorhabdus miraniensis	0	0	0	0	1	0	0	0	1
Bacteria;Bacteria_none;Pseudomonadota;Gammaproteobacteria;Enterobacterales;Morganellaceae;Providencia;Providencia huaxiensis	0	0	0	0	0	0	0	1	1
Bacteria;Bacteria_none;Pseudomonadota;Gammaproteobacteria;Enterobacterales;Morganellaceae;Proteus;Proteus mirabilis	0	0	0	1	0	0	0	0	1
Bacteria;Bacteria_none;Pseudomonadota;Gammaproteobacteria;Enterobacterales;Hafniaceae;Edwardsiella;Edwardsiella piscicida	0	0	0	1	0	0	0	0	1
Bacteria;Bacteria_none;Pseudomonadota;Gammaproteobacteria;Enterobacterales;Erwiniaceae;Tatumella;Tatumella punctata	0	1	0	0	0	0	0	0	1
Bacteria;Bacteria_none;Pseudomonadota;Gammaproteobacteria;Enterobacterales;Erwiniaceae;Rosenbergiella;Rosenbergiella nectarea	0	0	1	0	0	0	0	0	1
Bacteria;Bacteria_none;Pseudomonadota;Gammaproteobacteria;Enterobacterales;Erwiniaceae;Rosenbergiella;Rosenbergiella epipactidis	0	0	0	1	0	0	0	0	1
Bacteria;Bacteria_none;Pseudomonadota;Gammaproteobacteria;Enterobacterales;Erwiniaceae;Rosenbergiella;Rosenbergiella australiborealis	0	0	0	0	1	0	0	0	1
Bacteria;Bacteria_none;Pseudomonadota;Gammaproteobacteria;Enterobacterales;Pectobacteriaceae;Pectobacterium;Pectobacterium quasiaquaticum	0	0	0	1	0	0	0	0	1
Bacteria;Bacteria_none;Pseudomonadota;Gammaproteobacteria;Enterobacterales;Yersiniaceae;Chimaeribacter;Chimaeribacter californicus	0	0	0	1	0	0	0	0	1
Bacteria;Bacteria_none;Pseudomonadota;Gammaproteobacteria;Enterobacterales;Yersiniaceae;Serratia;Serratia entomophila	0	0	0	0	0	0	0	1	1
Bacteria;Bacteria_none;Bacillota;Bacilli;Lactobacillales;Lactobacillaceae;Companilactobacillus;Companilactobacillus heilongjiangensis	0	0	1	0	0	0	0	0	1
Bacteria;Bacteria_none;Pseudomonadota;Gammaproteobacteria;Pasteurellales;Pasteurellaceae;Haemophilus;Haemophilus influenzae	0	0	0	0	0	0	0	1	1
Bacteria;Bacteria_none;Pseudomonadota;Gammaproteobacteria;Pasteurellales;Pasteurellaceae;Actinobacillus;Actinobacillus lignieresii	0	0	1	0	0	0	0	0	1
Bacteria;Bacteria_none;Pseudomonadota;Gammaproteobacteria;Pasteurellales;Pasteurellaceae;Actinobacillus;Actinobacillus arthritidis	0	0	0	1	0	0	0	0	1
Bacteria;Bacteria_none;Bacillota;Bacilli;Lactobacillales;Aerococcaceae;Suicoccus;Suicoccus acidiformans	0	0	0	1	0	0	0	0	1
Bacteria;Bacteria_none;Bacillota;Bacilli;Lactobacillales;Lactobacillaceae;Apilactobacillus;Apilactobacillus quenuiae	0	0	1	0	0	0	0	0	1
Bacteria;Bacteria_none;Bacillota;Bacilli;Lactobacillales;Lactobacillaceae;Apilactobacillus;Apilactobacillus timberlakei	0	0	0	1	0	0	0	0	1
Bacteria;Bacteria_none;Pseudomonadota;Gammaproteobacteria;Oceanospirillales;Halomonadaceae;Halovibrio;Halovibrio salipaludis	0	0	0	0	0	1	0	0	1
Bacteria;Bacteria_none;Pseudomonadota;Gammaproteobacteria;Enterobacterales;Yersiniaceae;Serratia;Serratia inhibens	0	1	0	0	0	0	0	0	1
Bacteria;Bacteria_none;Pseudomonadota;Gammaproteobacteria;Moraxellales;Moraxellaceae;Acinetobacter;Acinetobacter kanungonis	0	0	0	0	0	0	0	1	1
Bacteria;Bacteria_none;Pseudomonadota;Gammaproteobacteria;Moraxellales;Moraxellaceae;Acinetobacter;Acinetobacter junii	0	0	0	0	0	1	0	0	1
Bacteria;Bacteria_none;Pseudomonadota;Gammaproteobacteria;Moraxellales;Moraxellaceae;Acinetobacter;Acinetobacter boissieri	0	0	0	0	0	0	0	1	1
Bacteria;Bacteria_none;Pseudomonadota;Gammaproteobacteria;Moraxellales;Moraxellaceae;Acinetobacter;Acinetobacter antiviralis	0	0	0	0	0	0	0	1	1
Bacteria;Bacteria_none;Bacillota;Bacilli;Lactobacillales;Lactobacillaceae;Lacticaseibacillus;Lacticaseibacillus paracasei	0	0	0	1	0	0	0	0	1
Bacteria;Bacteria_none;Pseudomonadota;Gammaproteobacteria;Enterobacterales;Yersiniaceae;Serratia;Serratia quinivorans	1	0	0	0	0	0	0	0	1
Bacteria;Bacteria_none;Pseudomonadota;Gammaproteobacteria;Enterobacterales;Erwiniaceae;Pantoea;Pantoea vagans	0	0	0	0	0	0	0	1	1
Bacteria;Bacteria_none;Pseudomonadota;Gammaproteobacteria;Enterobacterales;Erwiniaceae;Pantoea;Pantoea conspicua	0	0	0	0	0	1	0	0	1
Bacteria;Bacteria_none;Pseudomonadota;Gammaproteobacteria;Enterobacterales;Enterobacteriaceae;Klebsiella;Klebsiella michiganensis	0	0	0	1	0	0	0	0	1
Bacteria;Bacteria_none;Pseudomonadota;Gammaproteobacteria;Enterobacterales;Erwiniaceae;Pantoea;Pantoea anthophila	0	0	1	0	0	0	0	0	1
Bacteria;Bacteria_none;Pseudomonadota;Gammaproteobacteria;Enterobacterales;Enterobacteriaceae;Lelliottia;Lelliottia amnigena	0	0	0	0	0	0	0	1	1
Bacteria;Bacteria_none;Bacillota;Bacilli;Lactobacillales;Lactobacillaceae;Lactobacillus;Lactobacillus rodentium	1	0	0	0	0	0	0	0	1
Bacteria;Bacteria_none;Bacillota;Bacilli;Lactobacillales;Lactobacillaceae;Lactobacillus;Lactobacillus xujianguonis	0	0	0	0	1	0	0	0	1
Bacteria;Bacteria_none;Pseudomonadota;Gammaproteobacteria;Enterobacterales;Enterobacteriaceae;Kosakonia;Kosakonia radicincitans	0	0	1	0	0	0	0	0	1
Bacteria;Bacteria_none;Pseudomonadota;Gammaproteobacteria;Enterobacterales;Enterobacteriaceae;Kosakonia;Kosakonia quasisacchari	0	0	0	0	0	0	0	1	1
Bacteria;Bacteria_none;Bacillota;Bacilli;Lactobacillales;Lactobacillaceae;Lentilactobacillus;Lentilactobacillus parakefiri	0	0	1	0	0	0	0	0	1
Bacteria;Bacteria_none;Bacillota;Bacilli;Lactobacillales;Lactobacillaceae;Leuconostoc;Leuconostoc pseudomesenteroides	0	0	0	0	0	0	0	1	1
Bacteria;Bacteria_none;Bacillota;Bacilli;Lactobacillales;Lactobacillaceae;Levilactobacillus;Levilactobacillus tujiorum	1	0	0	0	0	0	0	0	1
Bacteria;Bacteria_none;Bacillota;Bacilli;Lactobacillales;Lactobacillaceae;Liquorilactobacillus;Liquorilactobacillus mali	0	0	0	0	0	1	0	0	1
Bacteria;Bacteria_none;Bacillota;Bacilli;Lactobacillales;Lactobacillaceae;Liquorilactobacillus;Liquorilactobacillus oeni	0	0	0	0	0	1	0	0	1
Bacteria;Bacteria_none;Bacillota;Clostridia;Eubacteriales;Clostridiaceae;Anoxynatronum;Anoxynatronum buryatiense	0	0	0	0	0	0	1	0	1
Bacteria;Bacteria_none;Pseudomonadota;Gammaproteobacteria;Enterobacterales;Enterobacteriaceae;Klebsiella;Klebsiella quasivariicola	0	0	0	1	0	0	0	0	1
Bacteria;Bacteria_none;Bacillota;Clostridia;Lachnospirales;Lachnospiraceae;Tyzzerella;[Clostridium] colinum	0	0	0	0	0	1	0	0	1
Bacteria;Bacteria_none;Bacillota;Clostridia;Lachnospirales;Natranaerovirgaceae;Natranaerovirga;Natranaerovirga hydrolytica	0	0	0	0	0	0	1	0	1
Bacteria;Bacteria_none;Bacillota;Negativicutes;Veillonellales;Veillonellaceae;Massilibacillus;Massilibacillus massiliensis	0	1	0	0	0	0	0	0	1
Bacteria;Bacteria_none;Pseudomonadota;Gammaproteobacteria;Enterobacterales;Enterobacteriaceae;Lelliottia;Lelliottia aquatilis	0	0	0	1	0	0	0	0	1
Bacteria;Bacteria_none;Pseudomonadota;Gammaproteobacteria;Enterobacterales;Enterobacteriaceae;Lelliottia;Lelliottia jeotgali	0	1	0	0	0	0	0	0	1
Bacteria;Bacteria_none;Pseudomonadota;Gammaproteobacteria;Enterobacterales;Enterobacteriaceae;Mangrovibacter;Mangrovibacter phragmitis	0	0	0	1	0	0	0	0	1
Bacteria;Bacteria_none;Pseudomonadota;Gammaproteobacteria;Enterobacterales;Enterobacteriaceae;Trabulsiella;Trabulsiella odontotermitis	0	0	0	1	0	0	0	0	1
Bacteria;Bacteria_none;Pseudomonadota;Gammaproteobacteria;Enterobacterales;Erwiniaceae;Pantoea;Pantoea ananatis	0	0	0	0	0	0	0	1	1
Bacteria;Bacteria_none;Pseudomonadota;Gammaproteobacteria;Enterobacterales;Erwiniaceae;Mixta;Mixta mediterraneensis	1	0	0	0	0	0	0	0	1
Bacteria;Bacteria_none;Pseudomonadota;Gammaproteobacteria;Enterobacterales;Erwiniaceae;Mixta;Mixta gaviniae	0	0	0	1	0	0	0	0	1
Bacteria;Bacteria_none;Pseudomonadota;Gammaproteobacteria;Enterobacterales;Erwiniaceae;Erwinia;Erwinia rhapontici	0	0	0	1	0	0	0	0	1
Bacteria;Bacteria_none;Pseudomonadota;Gammaproteobacteria;Enterobacterales;Erwiniaceae;Erwinia;Erwinia psidii	0	0	0	0	0	0	1	0	1
Bacteria;Bacteria_none;Pseudomonadota;Gammaproteobacteria;Enterobacterales;Erwiniaceae;Erwinia;Erwinia papayae	0	0	0	0	0	0	0	1	1
Bacteria;Bacteria_none;Pseudomonadota;Gammaproteobacteria;Enterobacterales;Enterobacteriaceae;Trabulsiella;Trabulsiella guamensis	0	0	0	0	0	0	1	0	1
Bacteria;Bacteria_none;Pseudomonadota;Gammaproteobacteria;Enterobacterales;Enterobacteriaceae;Mangrovibacter;Mangrovibacter plantisponsor	0	1	0	0	0	0	0	0	1
Bacteria;Bacteria_none;Pseudomonadota;Gammaproteobacteria;Enterobacterales;Enterobacteriaceae;Tenebrionibacter;Tenebrionibacter intestinalis	0	0	0	0	1	0	0	0	1
Bacteria;Bacteria_none;Bacillota;Bacilli;Lactobacillales;Lactobacillaceae;Lactobacillus;Lactobacillus johnsonii	0	0	0	0	0	0	0	1	1
Bacteria;Bacteria_none;Bacillota;Bacilli;Lactobacillales;Lactobacillaceae;Lactobacillus;Lactobacillus kefiranofaciens	0	0	0	0	0	0	0	1	1
Bacteria;Bacteria_none;Pseudomonadota;Gammaproteobacteria;Enterobacterales;Enterobacteriaceae;Pluralibacter;Pluralibacter pyrinus	1	0	0	0	0	0	0	0	1
Bacteria;Bacteria_none;Pseudomonadota;Gammaproteobacteria;Enterobacterales;Enterobacteriaceae;Phytobacter;Phytobacter palmae	0	0	0	0	0	0	0	1	1
Bacteria;Bacteria_none;Pseudomonadota;Gammaproteobacteria;Enterobacterales;Enterobacteriaceae;Mangrovibacter;Mangrovibacter yixingensis	0	0	0	1	0	0	0	0	1
Viruses;Viruses_Incertae_sedis;Viruses_Incertae_sedis;Viruses_Incertae_sedis;Viruses_Incertae_sedis;Viruses_Incertae_sedis;Viruses_Incertae_sedis;Thika virus	0	0	0	0	0	1	0	0	1
